华图教育	华图教育
异地中考	异地中考
自力教育	自力教育
精锐教育	精锐教育
新世界日语	新世界日语
深水埗	深水埗
太平山	太平山
浅水湾	浅水湾
海洋公园	海洋公园
会计	会计
香港海	香港海
迪斯尼	迪斯尼
眼妆	眼妆
辅导	辅导
建业地产	建业地产
环比	环比
战略定位	战略定位
远洋地产	远洋地产
异地	异地
房地产市场	房地产市场
房企	房企
中国房地产	中国房地产
写作	写作
调控	调控
恒大地产	恒大地产
保利房地产	保利房地产
康师傅	康师傅
冰红茶	冰红茶
统一鲜橙多	统一鲜橙多
地块	地块
平山	平山
乐百氏	乐百氏
新世界	新世界
阿萨姆奶茶	阿萨姆奶茶
凉茶	凉茶
脉动	脉动
远洋	远洋
和其正	和其正
果粒橙	果粒橙
美汁源	美汁源
统一绿茶	统一绿茶
香飘飘奶茶	香飘飘奶茶
和其正凉茶	和其正凉茶
营养快线	营养快线
贝奇野菜汁	贝奇野菜汁
罐装咖啡	罐装咖啡
萝卜汁	萝卜汁
七宝古镇	七宝古镇
哇哈哈	哇哈哈
雀巢罐装	雀巢罐装
房地产	房地产
哈雷	哈雷
單車	單車
菜汁	菜汁
南锣鼓巷	南锣鼓巷
一辆雅马哈	一辆雅马哈
杜卡迪	杜卡迪
雅马哈摩托	雅马哈摩托
地产	地产
开发商	开发商
城隍庙	城隍庙
风格的家具	风格的家具
床上四件套	床上四件套
卸妆油	卸妆油
夏至未至	夏至未至
那些我们一起追的女孩	那些我们一起追的女孩
柴静的文字	柴静的文字
莫言	莫言
美式家具	美式家具
白鹿原	白鹿原
九孔	九孔
眼影	眼影
家居	家居
为什么出发	为什么出发
欧式家具	欧式家具
周国平	周国平
《看见》	《看见》
孔被	孔被
孔棉	孔棉
SAT	SAT
《妞妞》	《妞妞》
散粉	散粉
诺维家衣柜	诺维家衣柜
席梦思床垫	席梦思床垫
红茶	红茶
挖鼻屎	挖鼻屎
香港购物	香港购物
地产公	地产公
卡迪	卡迪
遮瑕	遮瑕
雖然	雖然
田子坊	田子坊
侠盗飞车	侠盗飞车
开始接受	开始接受
英国零售商	英国零售商
保卫萝卜	保卫萝卜
色眼	色眼
美汁	美汁
新世	新世
王石	王石
SPF	SPF
轻盈防晒乳	轻盈防晒乳
彼得罗夫	彼得罗夫
防晒乳液	防晒乳液
晒乳液	晒乳液
得罗夫	得罗夫
乳液SPF	乳液SPF
PTR轻盈	PTR轻盈
实木	实木
绒被	绒被
妞妞	妞妞
小鳄鱼洗澡	小鳄鱼洗澡
文字	文字
野菜	野菜
八音盒	八音盒
养护洗发	养护洗发
奢华舒润	奢华舒润
华舒润养护	华舒润养护
舒润养护洗	舒润养护洗
丝蓓绮奢华	丝蓓绮奢华
洗发露	洗发露
润养护洗发	润养护洗发
丝蓓绮	丝蓓绮
养护洗发露	养护洗发露
达喀尔	达喀尔
接受	接受
这个游戏	这个游戏
海洋	海洋
摩托车	摩托车
建业	建业
一关	一关
快线	快线
植物大战僵尸	植物大战僵尸
考试	考试
读完	读完
金萝卜	金萝卜
深海	深海
水果忍者	水果忍者
杰倫	杰倫
歌曲	歌曲
专辑	专辑
虾米音乐	虾米音乐
万科	万科
金融中心	金融中心
理赔	理赔
金茂大厦	金茂大厦
圆桌	圆桌
家居饰品	家居饰品
女声	女声
好书	好书
单曲循环	单曲循环
《造王者》	《造王者》
溏心风暴	溏心风暴
少女的祈祷	少女的祈祷
杨千嬅	杨千嬅
鳄鱼	鳄鱼
幼稚	幼稚
果五	果五
iP	iP
摩托	摩托
造王者	造王者
席梦思	席梦思
这张专辑	这张专辑
PTR	PTR
地产公司	地产公司
书名	书名
北京	北京
大仁	大仁
追梦者	追梦者
主题曲	主题曲
一辈子的孤单	一辈子的孤单
迪士尼	迪士尼
歌词	歌词
不会喜欢你	不会喜欢你
我不会喜欢	我不会喜欢
读到	读到
钟嘉欣	钟嘉欣
陈柏霖	陈柏霖
郭敬明	郭敬明
义海豪情	义海豪情
骑摩托	骑摩托
窗帘	窗帘
古巨基	古巨基
我可能不会	我可能不会
买房	买房
白酒	白酒
容祖儿	容祖儿
林峰	林峰
连续剧	连续剧
房地产公司	房地产公司
丰乳肥臀	丰乳肥臀
绿城	绿城
四件套	四件套
美妆	美妆
美式	美式
很好听	很好听
烧仙草	烧仙草
诺基亚	诺基亚
喜欢你	喜欢你
Incredible	Incredible
香港购	香港购
坐地铁	坐地铁
手表	手表
坝	坝
地中海风	地中海风
教育	教育
纤长	纤长
忍者	忍者
会喜欢	会喜欢
一点儿	一点儿
融资	融资
粉底	粉底
堂主	堂主
课程	课程
优氧清衡	优氧清衡
凝乳	凝乳
cooper	cooper
眼唇卸妆	眼唇卸妆
酒业	酒业
放映	放映
主演	主演
iE	iE
保利	保利
祈祷	祈祷
地中海风格	地中海风格
骑着	骑着
不会爱	不会爱
五粮液	五粮液
白鹿	白鹿
楼盘	楼盘
得罗	得罗
故宫	故宫
万套	万套
亿元	亿元
Gomez	Gomez
集团	集团
会做噩梦的	会做噩梦的
一代宗师	一代宗师
孤单	孤单
罐装	罐装
刷头	刷头
豫园	豫园
票房	票房
续集	续集
颐和园	颐和园
减肥	减肥
商标	商标
粉底液	粉底液
当幸福来敲门	当幸福来敲门
分析师	分析师
金茂	金茂
周杰伦	周杰伦
追梦	追梦
玛花纤体	玛花纤体
一九四二	一九四二
血滴子	血滴子
空气质量	空气质量
新书	新书
修身堂	修身堂
张玉珊	张玉珊
來回	來回
<泰囧>	<泰囧>
巴顿	巴顿
奇事	奇事
本杰明	本杰明
好电影	好电影
《血滴子》	《血滴子》
霍比特人	霍比特人
和园	和园
李安	李安
会看到	会看到
王宝强	王宝强
只希望	只希望
笑料	笑料
载我	载我
少年派	少年派
拓展	拓展
html	html
好好听	好好听
骓驰	骓驰
在听	在听
高层	高层
Hyuk	Hyuk
陈奕迅	陈奕迅
最幸福的事	最幸福的事
王老吉	王老吉
睫毛膏	睫毛膏
全键盘	全键盘
爱婴岛	爱婴岛
高考	高考
魔戒	魔戒
导演	导演
生化危机	生化危机
头脑	头脑
GNC	GNC
dib	dib
前景	前景
绿地	绿地
按压	按压
电视剧	电视剧
亲子活动	亲子活动
怪物	怪物
侠盗	侠盗
博士蛙	博士蛙
平的	平的
万分	万分
run	run
触动	触动
开发	开发
四件	四件
九四	九四
妆容	妆容
必瘦站	必瘦站
一兆韦德	一兆韦德
vb	vb
肥了	肥了
浮夸	浮夸
学校	学校
《寒战》	《寒战》
睫毛	睫毛
漫画	漫画
僵尸	僵尸
棉被	棉被
红酒	红酒
茶	茶
丝被	丝被
片子	片子
财务	财务
雪景	雪景
参加	参加
上色	上色
保险的	保险的
风格的	风格的
泰囧	泰囧
奇幻漂流	奇幻漂流
胜地	胜地
草原	草原
酒厂	酒厂
思考	思考
王家卫	王家卫
尖沙咀	尖沙咀
IMAX	IMAX
主题	主题
项链	项链
爱你	爱你
Break	Break
郑州	郑州
爱室	爱室
呜呜	呜呜
统一	统一
唇彩	唇彩
最难用	最难用
幸福的事	幸福的事
这首歌	这首歌
演技	演技
我们	我们
劳资	劳资
唱	唱
一本书	一本书
黑衣人	黑衣人
彼得	彼得
眼唇	眼唇
发怒	发怒
夜景	夜景
使馆	使馆
古镇	古镇
键盘	键盘
小刚	小刚
贺岁	贺岁
快乐到家	快乐到家
电影	电影
噩梦	噩梦
影院	影院
两杯	两杯
一辈子	一辈子
计算机	计算机
看见	看见
那些年	那些年
畅销书	畅销书
四小时	四小时
车祸	车祸
快乐大本营	快乐大本营
年级	年级
亲子	亲子
歌声	歌声
减肥药	减肥药
衣柜	衣柜
澳洲	澳洲
牛奶公司	牛奶公司
咕噜	咕噜
北京人	北京人
避孕	避孕
走下	走下
肥大	肥大
粤语	粤语
徐峥	徐峥
快乐家族	快乐家族
香港	香港
王品台塑牛排	王品台塑牛排
Leo	Leo
瓶盖	瓶盖
战略	战略
西提牛排	西提牛排
牛排	牛排
我家宝贝	我家宝贝
长大后	长大后
生化	生化
延展性	延展性
泰子椰	泰子椰
海风	海风
使用前	使用前
车险	车险
简单大方	简单大方
temp	temp
终端	终端
护肤彩妆	护肤彩妆
旅游	旅游
韦德	韦德
红木	红木
佑佑	佑佑
王者	王者
再次感谢	再次感谢
衣衣	衣衣
越狱	越狱
不喝	不喝
酒品	酒品
心愿	心愿
兰蔻	兰蔻
童话	童话
III	III
零售	零售
预告片	预告片
卸妆	卸妆
作家	作家
PT	PT
前叉	前叉
上海	上海
保险公司	保险公司
酿造	酿造
眼线	眼线
少女	少女
新娘	新娘
国车	国车
减肥计划	减肥计划
瘦了	瘦了
上映	上映
租房	租房
保了	保了
深沉	深沉
arts	arts
美家	美家
这本	这本
圣诞快乐	圣诞快乐
美克	美克
去影院	去影院
张武安	张武安
日本佐贺	日本佐贺
这种风	这种风
脑海	脑海
小朋友	小朋友
elena	elena
笑点	笑点
威尔士健身	威尔士健身
虾米	虾米
減肥	減肥
大降	大降
彩妆	彩妆
新年	新年
车险公司	车险公司
机车	机车
家具	家具
少吃	少吃
弃	弃
服务差	服务差
业主	业主
自行车	自行车
无可挑剔	无可挑剔
配音	配音
好听的	好听的
專輯	專輯
Joy	Joy
美克美家	美克美家
网站	网站
几万	几万
台词	台词
勾兑	勾兑
兜风	兜风
花	花
K歌	K歌
气场	气场
敲门	敲门
尺码	尺码
愿望	愿望
粗面	粗面
喜剧	喜剧
中性	中性
课	课
戏	戏
雄风	雄风
平实	平实
好听	好听
漆	漆
搬运车	搬运车
km/h	km/h
加速	加速
叉车	叉车
概念车	概念车
骨肉	骨肉
穿着舒服	穿着舒服
水油	水油
尽在迪卡侬	尽在迪卡侬
感悟	感悟
出声	出声
佐贺	佐贺
舒服	舒服
看完	看完
网点	网点
卡宴	卡宴
俏江南	俏江南
预计	预计
十月	十月
销量排行	销量排行
家长	家长
M记	M记
流线	流线
WRX	WRX
同级	同级
讲	讲
魏家凉皮	魏家凉皮
地中海	地中海
ago	ago
Natio	Natio
故乡	故乡
新闻	新闻
奇瑞	奇瑞
房网	房网
Decay	Decay
Urban	Urban
我不会	我不会
bug	bug
Apple	Apple
H值	H值
幼儿园	幼儿园
植物园	植物园
七孔	七孔
疗程	疗程
定妆	定妆
斯巴鲁	斯巴鲁
高潮	高潮
百搭	百搭
中秋	中秋
STI	STI
试用报告	试用报告
D版	D版
太平	太平
翼豹	翼豹
bst	bst
情节	情节
健身	健身
什么	什么
葡萄籽	葡萄籽
继承	继承
剪辑	剪辑
眼周	眼周
威斯汀	威斯汀
rot	rot
抹开	抹开
佩戴	佩戴
抬头纹	抬头纹
痘	痘
水嫩	水嫩
缺水	缺水
脑海里	脑海里
屋顶	屋顶
mps	mps
思佳美儿	思佳美儿
支持	支持
祝大家	祝大家
上海通用	上海通用
车价	车价
细分市场	细分市场
血拼	血拼
型车	型车
讽刺	讽刺
下课	下课
肠道	肠道
结尾	结尾
人们	人们
男宝	男宝
基金会	基金会
我要减肥	我要减肥
恒大	恒大
吉他	吉他
手动	手动
哈弗	哈弗
开始	开始
海里	海里
胎压	胎压
速锐	速锐
威尔士	威尔士
逸动	逸动
卧室	卧室
本田歌诗图	本田歌诗图
悦达起亚	悦达起亚
东风	东风
ayman	ayman
润肌	润肌
喜欢的朋友	喜欢的朋友
保时捷	保时捷
IOS	IOS
白精	白精
好好好	好好好
SLK	SLK
打哈气	打哈气
绿茶	绿茶
交房	交房
收紧	收紧
ALA	ALA
喜欢上	喜欢上
坐地	坐地
期末	期末
诚实	诚实
眼膜	眼膜
美白精	美白精
收缩毛孔	收缩毛孔
文学	文学
试用	试用
很好喝	很好喝
电影票	电影票
大破天幕	大破天幕
Cayman	Cayman
果皮	果皮
改善	改善
海通	海通
十年前	十年前
乐就	乐就
解毒	解毒
香型	香型
奥斯卡	奥斯卡
祛痘	祛痘
sli	sli
包小	包小
车	车
丝塔芙保湿	丝塔芙保湿
保湿润肤	保湿润肤
睡眠面膜	睡眠面膜
Sel	Sel
收缩	收缩
细分	细分
订位	订位
清爽	清爽
萝卜	萝卜
环境差服务	环境差服务
酒	酒
白	白
anli	anli
丝瓜水	丝瓜水
千纤草	千纤草
嫩肤	嫩肤
景逸	景逸
阿胶	阿胶
卸妆液	卸妆液
晒黑	晒黑
天然矿泉水	天然矿泉水
漂流	漂流
跑跑	跑跑
碧防晒乳液	碧防晒乳液
新碧防晒乳	新碧防晒乳
体重	体重
一无所有	一无所有
爱室·活动	爱室·活动
畅销书作	畅销书作
机会有限	机会有限
东风标致	东风标致
白面霜	白面霜
喝汤	喝汤
提速	提速
默念	默念
ucat	ucat
防晒露	防晒露
违法	违法
迪卡侬	迪卡侬
红景天幼白	红景天幼白
面霜	面霜
试用中心	试用中心
hoto	hoto
百万富翁	百万富翁
好多啊	好多啊
Heart	Heart
朋友	朋友
MM	MM
淮海	淮海
Sir	Sir
洋快餐	洋快餐
http	http
相宜本草	相宜本草
有效果	有效果
立顿	立顿
Benso	Benso
看了一遍	看了一遍
翅膀	翅膀
一切尽在	一切尽在
明天的	明天的
均价	均价
进军	进军
BB霜	BB霜
妮维雅	妮维雅
进水	进水
连衣裙	连衣裙
圣诞	圣诞
心愿风暴	心愿风暴
护手霜	护手霜
冰凉	冰凉
亲亲	亲亲
速生鸡	速生鸡
幸福快乐	幸福快乐
百度知道	百度知道
品牌	品牌
怎么样	怎么样
产品效果	产品效果
如何	如何
我怀念	我怀念
风暴	风暴
媒体人	媒体人
美即面膜	美即面膜
可能不	可能不
三轮	三轮
裙子	裙子
MINI	MINI
国老	国老
欧舒丹	欧舒丹
帮主	帮主
它家的	它家的
强调	强调
品牌怎么样	品牌怎么样
网上购物	网上购物
车型	车型
地公	地公
美白	美白
一本	一本
早安心语	早安心语
摔跤	摔跤
早安	早安
CBA	CBA
排轮	排轮
直排	直排
教我滑板	教我滑板
滑板教我滑	滑板教我滑
轮滑	轮滑
轮滑运动	轮滑运动
oxelo	oxelo
斯内德	斯内德
保湿润肤乳	保湿润肤乳
有机宝宝	有机宝宝
圣诞心愿	圣诞心愿
stm	stm
lena	lena
情歌	情歌
喝完	喝完
全屏	全屏
滑冰	滑冰
毛的	毛的
完整版	完整版
购物	购物
加时	加时
溜冰	溜冰
膝盖	膝盖
姆斯	姆斯
静的	静的
华语	华语
加满	加满
巴巴	巴巴
乳房	乳房
想去的	想去的
杜兰特	杜兰特
call	call
护肤品	护肤品
风雪	风雪
圣诞节	圣诞节
OE	OE
小男孩	小男孩
nuk奶瓶	nuk奶瓶
快乐的	快乐的
影票	影票
健康成长	健康成长
美白保湿	美白保湿
体力	体力
希望	希望
安利	安利
agoda	agoda
雪铁龙	雪铁龙
奶	奶
百胜	百胜
家纺	家纺
悦达	悦达
古典	古典
腻	腻
畅销的	畅销的
大战	大战
干皮	干皮
LK	LK
起亚	起亚
很舒适	很舒适
可挑剔	可挑剔
途观	途观
red	red
喝不	喝不
哺乳	哺乳
小班	小班
肌膚	肌膚
仙草	仙草
uk奶瓶	uk奶瓶
瓶身	瓶身
皮肤	皮肤
Fan	Fan
好车	好车
通关	通关
胡萝卜	胡萝卜
奶嘴	奶嘴
床垫	床垫
代购	代购
大衣	大衣
月亮	月亮
阳光	阳光
依旧是	依旧是
那时候	那时候
自杀	自杀
阿尔派	阿尔派
十一月	十一月
润肤乳	润肤乳
饮用	饮用
敞篷	敞篷
喂药	喂药
孩纸	孩纸
身体乳	身体乳
berla	berla
倒入	倒入
贝亲奶瓶	贝亲奶瓶
培训	培训
深刻的	深刻的
宽口	宽口
爱室丽	爱室丽
Home	Home
轻盈	轻盈
改编	改编
萄酒的	萄酒的
兔斯基	兔斯基
aveeno	aveeno
宝马	宝马
军绿	军绿
沃尔沃	沃尔沃
小公主	小公主
车撞	车撞
车手	车手
差服务	差服务
保湿精华	保湿精华
质地	质地
贝亲	贝亲
小帽子	小帽子
发酵	发酵
登山鞋	登山鞋
探路者	探路者
小说	小说
可愛	可愛
葡萄酒的	葡萄酒的
columbia	columbia
环境不好	环境不好
坏人	坏人
打游戏	打游戏
那麼	那麼
品系	品系
奇幻	奇幻
公测	公测
郁美净	郁美净
月饼	月饼
推迟	推迟
水润	水润
祝愿	祝愿
试用的	试用的
一天	一天
现实中	现实中
nuk	nuk
内饰	内饰
歌诗图	歌诗图
补水面膜	补水面膜
关键词	关键词
喜羊羊	喜羊羊
球队	球队
小脸	小脸
雀氏	雀氏
会爱	会爱
HTC	HTC
adidas	adidas
保温	保温
排期	排期
很久	很久
面膜	面膜
温和不刺激	温和不刺激
吸水	吸水
奥迪	奥迪
旺角	旺角
刻度不准	刻度不准
腹部	腹部
两岁	两岁
成为	成为
音悦台	音悦台
今天第一	今天第一
可以	可以
cay	cay
喜欢这件	喜欢这件
肯德基	肯德基
关门	关门
飞车	飞车
常吃	常吃
等下	等下
出演	出演
不失可爱	不失可爱
喝了	喝了
清水	清水
排量	排量
破天	破天
山顶	山顶
滋润度	滋润度
福克斯	福克斯
成交	成交
话筒	话筒
包饺子	包饺子
效果如何	效果如何
间进	间进
不能忘	不能忘
诚意	诚意
轮滑鞋	轮滑鞋
轻按	轻按
丝瓜	丝瓜
书	书
爱的人	爱的人
瘦瘦	瘦瘦
出版社	出版社
刘女士	刘女士
必胜客	必胜客
拉风的	拉风的
水啊	水啊
有余	有余
税费	税费
恋人	恋人
科学家	科学家
正能量	正能量
地下通道	地下通道
超市贵	超市贵
瓶子	瓶子
打字	打字
角质	角质
机票	机票
眼霜	眼霜
惠氏	惠氏
加油	加油
运动产品	运动产品
化妆品	化妆品
书籍	书籍
滋潤	滋潤
god	god
麻将	麻将
催化	催化
层次	层次
红景天	红景天
服务好周到	服务好周到
菲比纸尿裤	菲比纸尿裤
青春	青春
无关	无关
慈善	慈善
护具	护具
圣诞老人	圣诞老人
瓜皮	瓜皮
子女	子女
幼儿	幼儿
风情帽	风情帽
教学	教学
志愿者	志愿者
学轮滑	学轮滑
心语	心语
滑板	滑板
狗狗	狗狗
收钱	收钱
mbi	mbi
单子	单子
朴实	朴实
MIN	MIN
上山	上山
难用	难用
小车	小车
KFC	KFC
滴答	滴答
次次	次次
游戏	游戏
耳机	耳机
莘庄百盛	莘庄百盛
大片拍摄	大片拍摄
拍摄花絮	拍摄花絮
想起	想起
胖了	胖了
视频	视频
暖暖的	暖暖的
十二生肖	十二生肖
岗位	岗位
好用	好用
保湿面	保湿面
选用	选用
宝大祥	宝大祥
红薯	红薯
演唱	演唱
stl	stl
大润发	大润发
淡水	淡水
片拍	片拍
发育	发育
底盘	底盘
性格	性格
布朗博士	布朗博士
纸尿片	纸尿片
鲁西南	鲁西南
肤乳	肤乳
家印	家印
用量	用量
试用中	试用中
增压	增压
演唱会	演唱会
菲比	菲比
太远	太远
修身	修身
车速	车速
小王	小王
中环	中环
订房	订房
细腻、	细腻、
外形	外形
温暖	温暖
宣传	宣传
RX	RX
老街	老街
玩得好	玩得好
闪亮	闪亮
玻璃奶瓶	玻璃奶瓶
oda	oda
概率	概率
干爽	干爽
单调	单调
提车	提车
投诉	投诉
妆品	妆品
混搭	混搭
保濕	保濕
申请售后	申请售后
补水效果	补水效果
巴鲁	巴鲁
标致	标致
冬至	冬至
液压	液压
太阳城路	太阳城路
环境差了些	环境差了些
ENO	ENO
久违	久违
顾问	顾问
iphone	iphone
纪录片	纪录片
奶粉	奶粉
起步	起步
大通学堂	大通学堂
西小河	西小河
好幸	好幸
去角质	去角质
含税价	含税价
车展	车展
优阶	优阶
预期	预期
MV	MV
保湿面膜	保湿面膜
房价	房价
凉皮	凉皮
安车险	安车险
提亮	提亮
学堂	学堂
通学	通学
多美滋	多美滋
读书	读书
曼谷	曼谷
飘逸	飘逸
色系	色系
奶茶	奶茶
掘金	掘金
投保	投保
命运	命运
春夏	春夏
发现	发现
量排	量排
平安车险	平安车险
新一代	新一代
油耗	油耗
一章	一章
童装	童装
古越	古越
SERGE	SERGE
上海人	上海人
机子	机子
大觉	大觉
股份有限公司	股份有限公司
软软的	软软的
思想	思想
IQ	IQ
沉重	沉重
想你	想你
白皙	白皙
MAJOR	MAJOR
NBA球星	NBA球星
pring	pring
零售商	零售商
洗面奶	洗面奶
赛道	赛道
响起	响起
肌肤水	肌肤水
调味	调味
白面	白面
知性	知性
农业	农业
虽然环境差	虽然环境差
上身	上身
生肖	生肖
出版	出版
匹马	匹马
高性能	高性能
妈咪宝贝	妈咪宝贝
Ps	Ps
色斑	色斑
腻的	腻的
新专辑	新专辑
儿童医院	儿童医院
DMI	DMI
纸尿	纸尿
百雀羚	百雀羚
防水透气	防水透气
好莱坞	好莱坞
吉兆	吉兆
脂肪	脂肪
苹果	苹果
免了	免了
保湿	保湿
用酒	用酒
球星	球星
奶瓶	奶瓶
红屁	红屁
看法	看法
手霜	手霜
洗面	洗面
梨子	梨子
宝宝	宝宝
志愿	志愿
受损	受损
仪器	仪器
湿疹	湿疹
很结实	很结实
帖子	帖子
争议	争议
继续	继续
瑞诗	瑞诗
江南style	江南style
雀巢奶粉	雀巢奶粉
小家伙	小家伙
涡轮增压	涡轮增压
油脂分泌	油脂分泌
合成	合成
生病	生病
平安银行	平安银行
纸尿裤	纸尿裤
初生	初生
尿片	尿片
商场投诉	商场投诉
费贵	费贵
吃饭环境	吃饭环境
咖啡厅	咖啡厅
GN	GN
喜欢这款	喜欢这款
美白效果	美白效果
什么值得买	什么值得买
屁屁	屁屁
转机	转机
做鬼脸	做鬼脸
滑行	滑行
规则	规则
卫生差	卫生差
珊瑚	珊瑚
记事	记事
法兰西	法兰西
美素	美素
房产	房产
剧情	剧情
正经	正经
秋日	秋日
神往	神往
感觉	感觉
微博	微博
官方微博	官方微博
关注	关注
上涨	上涨
污垢	污垢
祛斑	祛斑
瑜伽	瑜伽
喷雾	喷雾
花王	花王
生意兴隆	生意兴隆
樱桃	樱桃
物业	物业
piri	piri
巨划算	巨划算
保湿效果	保湿效果
投訴	投訴
因子	因子
一整天	一整天
麦当劳	麦当劳
作者	作者
居中	居中
不紧	不紧
效果	效果
练习	练习
秘诀	秘诀
浓咖啡	浓咖啡
好次	好次
水冲	水冲
冗长	冗长
多汁	多汁
上课	上课
ktv	ktv
环境优雅的	环境优雅的
大足	大足
实中	实中
推开	推开
变速箱	变速箱
不值	不值
波尔多	波尔多
斑点	斑点
茉莉	茉莉
迎新年	迎新年
高清MV	高清MV
MV-音悦	MV-音悦
特色	特色
乱差	乱差
手袋	手袋
AX	AX
爬山	爬山
Franc	Franc
云天	云天
报价	报价
AJ	AJ
第十	第十
售后	售后
脏乱差	脏乱差
曹杨	曹杨
前途	前途
NBA	NBA
柔滑	柔滑
布朗	布朗
定损	定损
好吸	好吸
人寿	人寿
青山	青山
将全	将全
韩版	韩版
投诉热	投诉热
作用	作用
倩碧	倩碧
是我最爱	是我最爱
冰冰	冰冰
裤	裤
质量差	质量差
坐垫	坐垫
上海大众	上海大众
胶原蛋白	胶原蛋白
条件差	条件差
养颜	养颜
球员	球员
嘉兴	嘉兴
多喝	多喝
早教	早教
太划算	太划算
出头	出头
老百姓	老百姓
过瘾	过瘾
毛衣	毛衣
床	床
甜美	甜美
维生素	维生素
投诉电话	投诉电话
执行	执行
流行	流行
香蕉	香蕉
差距	差距
地毯	地毯
RGE	RGE
钥匙	钥匙
机构	机构
同比	同比
使用	使用
扇贝	扇贝
蜜桃	蜜桃
敷脸	敷脸
品牌奶粉	品牌奶粉
真的很不错	真的很不错
土豆网	土豆网
特别	特别
金装	金装
华丽丽	华丽丽
就诊	就诊
签名	签名
惠氏奶粉	惠氏奶粉
球	球
涂抹	涂抹
CAT	CAT
女孩	女孩
帮宝适	帮宝适
紧绷	紧绷
幸福	幸福
很不错	很不错
修护	修护
酒类	酒类
顺丰	顺丰
边吃	边吃
Pas	Pas
宾馆环境	宾馆环境
死亡	死亡
女主	女主
失落	失落
优雅舒适	优雅舒适
不油腻	不油腻
马德	马德
餐桌	餐桌
文化	文化
购买日期	购买日期
数字电视	数字电视
毛孔	毛孔
联手	联手
雷霆	雷霆
Av	Av
学者	学者
滋润	滋润
电话	电话
新乡	新乡
手感	手感
原著	原著
滑滑的	滑滑的
菜心	菜心
学家	学家
大灯	大灯
蛋白质	蛋白质
逻辑	逻辑
学校的	学校的
市场占有率	市场占有率
婴儿食品	婴儿食品
首选	首选
车身	车身
摄像	摄像
紧急	紧急
墙壁	墙壁
好吸收	好吸收
英镑	英镑
罐奶粉	罐奶粉
皮皮	皮皮
雅培奶粉	雅培奶粉
喜欢喝	喜欢喝
中毒	中毒
玩游戏	玩游戏
润肤	润肤
各自	各自
柔肤	柔肤
感人	感人
喜之郎	喜之郎
法拉利	法拉利
色彩	色彩
床上	床上
用钱	用钱
国际影城	国际影城
预告	预告
童星	童星
法国品牌	法国品牌
企业	企业
冰的	冰的
演出	演出
心大	心大
心想	心想
少的	少的
中山公园	中山公园
旗舰店	旗舰店
蓝白	蓝白
人格	人格
丹麦蓝罐	丹麦蓝罐
曲奇	曲奇
胀气	胀气
色调	色调
mam	mam
几何	几何
imb	imb
车迷	车迷
猪肉脯	猪肉脯
登机牌	登机牌
绝望	绝望
电子产品	电子产品
对比	对比
先于	先于
汽车	汽车
平淡	平淡
就餐环境好	就餐环境好
感谢大家	感谢大家
饼	饼
有弹性	有弹性
世界	世界
日内瓦	日内瓦
冲锋衣	冲锋衣
投资	投资
橄榄	橄榄
油光	油光
不爱吃	不爱吃
就餐环境	就餐环境
环境差	环境差
精华液	精华液
防晒	防晒
婴幼儿	婴幼儿
香蕉牛奶	香蕉牛奶
占有率	占有率
价格高	价格高
最划算	最划算
油腻	油腻
客服	客服
环境优雅	环境优雅
封面	封面
婴儿用品	婴儿用品
Woo	Woo
高贵	高贵
婴幼	婴幼
三星	三星
向往	向往
打底	打底
手机品牌	手机品牌
人情味	人情味
布达佩斯	布达佩斯
着火	着火
小米	小米
甲醛	甲醛
工作	工作
格高	格高
爱生活	爱生活
年度	年度
进攻	进攻
连接	连接
anta	anta
迷彩	迷彩
装扮	装扮
眼睛	眼睛
海苔	海苔
人生	人生
被子	被子
质地轻	质地轻
住宿	住宿
捷安特	捷安特
肤质	肤质
猴子	猴子
服务好	服务好
参数	参数
冒险	冒险
气球	气球
滑雪	滑雪
白醋	白醋
标准	标准
加一层	加一层
眼部	眼部
品数	品数
索的	索的
摄像头	摄像头
超跑	超跑
户外活动	户外活动
好贵	好贵
NIKE	NIKE
棉花糖	棉花糖
读者	读者
薯条	薯条
个人感觉	个人感觉
爱室丽家居	爱室丽家居
常州百盛	常州百盛
财险	财险
特价机票	特价机票
佩服	佩服
残留	残留
代谢	代谢
生姜	生姜
肌肤	肌肤
对您有用吗	对您有用吗
评价	评价
真心	真心
回家	回家
行程	行程
黄飞红	黄飞红
anna	anna
一定能	一定能
有用吗	有用吗
下个月	下个月
排放	排放
elina	elina
排毒	排毒
石榴	石榴
肤色	肤色
南翔小笼	南翔小笼
张电	张电
京城	京城
亚马逊对比	亚马逊对比
空瓶	空瓶
录制	录制
一口气	一口气
澳大利亚	澳大利亚
教会	教会
GE	GE
预测	预测
首席	首席
培养	培养
耳光馄饨	耳光馄饨
动人	动人
速成鸡事件	速成鸡事件
细纹	细纹
爱室丽家	爱室丽家
共勉	共勉
SUV	SUV
乳液	乳液
happy	happy
进驻	进驻
养护	养护
碧桂园	碧桂园
交警	交警
西安市	西安市
asia	asia
隔离	隔离
豪大大鸡排	豪大大鸡排
悠哈	悠哈
吃香	吃香
上演	上演
防腐	防腐
油站	油站
手上	手上
游览	游览
湿润	湿润
板车	板车
冷	冷
动力	动力
新年快乐	新年快乐
坚强	坚强
开水	开水
周末	周末
环境	环境
去皱	去皱
激情品牌	激情品牌
DT	DT
博士	博士
速成鸡	速成鸡
打球	打球
东西太烂	东西太烂
观众	观众
何况	何况
手指	手指
雀羚	雀羚
吹风机	吹风机
服用	服用
无刺激	无刺激
循环	循环
高尔夫	高尔夫
珠江夜游	珠江夜游
芮欧	芮欧
依云	依云
ache	ache
一定	一定
小鸟	小鸟
啫喱	啫喱
地方	地方
球拍	球拍
输了	输了
活动开始	活动开始
抗衰老	抗衰老
直接	直接
洗净	洗净
黑白	黑白
洗澡	洗澡
好想吃	好想吃
挑剔	挑剔
车头	车头
西风	西风
消协	消协
嘎嘎	嘎嘎
偷偷	偷偷
鸡翅	鸡翅
不油	不油
很旧	很旧
好喝	好喝
通宵	通宵
做梦	做梦
小朋友们	小朋友们
泡沫	泡沫
建设	建设
分明	分明
首映	首映
单车	单车
跑车	跑车
护肤	护肤
天亮	天亮
水面	水面
UK	UK
便宜	便宜
新安怡	新安怡
信念	信念
化妆	化妆
风险	风险
亚马逊	亚马逊
演员	演员
京东	京东
眼圈	眼圈
不刺激	不刺激
兰博基尼	兰博基尼
豆瓣	豆瓣
人物	人物
委屈	委屈
秋冬季	秋冬季
汤可	汤可
保暖	保暖
预存	预存
励志	励志
老子	老子
献给	献给
放松一下	放松一下
广州车展	广州车展
交通便	交通便
胶原	胶原
电动车	电动车
超级划算	超级划算
我家女儿	我家女儿
市场价	市场价
斯巴	斯巴
黑暗	黑暗
温和	温和
因素	因素
葡萄酒	葡萄酒
南航	南航
滑板车	滑板车
中国球	中国球
活性	活性
门口	门口
开会	开会
悦轩	悦轩
控油	控油
天速	天速
初中	初中
CX	CX
生鸡	生鸡
便秘	便秘
结实	结实
交通便利	交通便利
尿布	尿布
骑行	骑行
审美	审美
保暖性	保暖性
rds	rds
节奏	节奏
虫子	虫子
兰花	兰花
oma	oma
聚餐	聚餐
贝拉	贝拉
发售	发售
柠檬汁	柠檬汁
引擎	引擎
发货速度	发货速度
质量怎么样	质量怎么样
双方	双方
提供	提供
免疫	免疫
矫情	矫情
外套	外套
机时	机时
有油	有油
景天	景天
浸泡	浸泡
很划算	很划算
墨镜	墨镜
通道	通道
四肢	四肢
burger	burger
衣恋	衣恋
教授	教授
抑制	抑制
补水保湿	补水保湿
保湿霜	保湿霜
法兰	法兰
部队	部队
技巧	技巧
模型	模型
ping	ping
肉粉	肉粉
韩式	韩式
公园	公园
Nat	Nat
大胆	大胆
教你	教你
曼秀雷敦	曼秀雷敦
香料	香料
流传	流传
NAKED	NAKED
信赖	信赖
尼康	尼康
天喔	天喔
小女孩	小女孩
房子	房子
用纸	用纸
斯卡	斯卡
河北	河北
拉链	拉链
延伸	延伸
紧凑	紧凑
必看	必看
地下	地下
好累	好累
合并	合并
格林豪泰	格林豪泰
好帅	好帅
食物	食物
上火	上火
宣传片	宣传片
要命	要命
人餐	人餐
奶粉质量差	奶粉质量差
干燥	干燥
就餐	就餐
各国	各国
无效	无效
剪刀	剪刀
眼球	眼球
酒家	酒家
油费	油费
重温	重温
流通	流通
节操	节操
中国联通	中国联通
维生素C	维生素C
保湿乳	保湿乳
值得买	值得买
道德	道德
日新	日新
国美电器	国美电器
燕麦	燕麦
自行	自行
金融	金融
常好用	常好用
Spa	Spa
奥特曼	奥特曼
骗子	骗子
被挤	被挤
迪卡	迪卡
创新	创新
母乳	母乳
星星火	星星火
淮海百盛	淮海百盛
上大	上大
父亲	父亲
物油	物油
愉悦	愉悦
DIY	DIY
淑女	淑女
偶像	偶像
护身	护身
全力	全力
水保	水保
不怕	不怕
平台	平台
激发	激发
天堂	天堂
矿物	矿物
爸妈	爸妈
肠胃	肠胃
嫌弃	嫌弃
基于	基于
细节	细节
湖南	湖南
颐和安缦	颐和安缦
老师	老师
食客	食客
蒙牛	蒙牛
试验	试验
很优	很优
强劲	强劲
星火	星火
自觉	自觉
爷们	爷们
香浓	香浓
限量版	限量版
鲜芋仙	鲜芋仙
光泽	光泽
主办	主办
小事	小事
搞笑	搞笑
畅销	畅销
前进	前进
药	药
用法	用法
趣岳计划	趣岳计划
波音	波音
私家趣岳计	私家趣岳计
吉隆坡	吉隆坡
新加坡	新加坡
澳航	澳航
台湾	台湾
水波潋滟	水波潋滟
自费	自费
斯里兰卡	斯里兰卡
曲径清幽、	曲径清幽、
共同关注	共同关注
庭院隐现	庭院隐现
飞机	飞机
清幽、水波	清幽、水波
水波潋滟、	水波潋滟、
斯里	斯里
难度	难度
新马	新马
曲径清幽	曲径清幽
安曼	安曼
南方航空	南方航空
小魔	小魔
压缩	压缩
透气性	透气性
配方奶粉	配方奶粉
好使	好使
政策	政策
惠普	惠普
评价四星	评价四星
承受	承受
舒适	舒适
梦想	梦想
故事	故事
圆满结束	圆满结束
辅食	辅食
气息	气息
许愿	许愿
死鸡	死鸡
过山车	过山车
学生	学生
很有感	很有感
捷星航空	捷星航空
蛋疼	蛋疼
酒精	酒精
丽家	丽家
热带	热带
香港代购	香港代购
修复	修复
巴马	巴马
滑滑	滑滑
危机	危机
景点	景点
加比	加比
携程旅行网	携程旅行网
鸡排	鸡排
得瑟	得瑟
乡村	乡村
激活	激活
饮料	饮料
最开心的	最开心的
金字塔	金字塔
长大	长大
自拍	自拍
雀巢	雀巢
臀部	臀部
竞技	竞技
花絮	花絮
冲突	冲突
适量	适量
钢铁	钢铁
马力	马力
Jetst	Jetst
值得信赖	值得信赖
龙潭	龙潭
营造	营造
人情	人情
很好用	很好用
乐园	乐园
乐乐	乐乐
又一个	又一个
变小	变小
行车	行车
撞色	撞色
亚洲地区	亚洲地区
携程旅行	携程旅行
新生儿	新生儿
病鸡	病鸡
孙子	孙子
专用	专用
国行	国行
小面	小面
ring	ring
轻薄	轻薄
车时	车时
变速	变速
摔了	摔了
自在	自在
感冒	感冒
感动	感动
车友	车友
姓名	姓名
看到	看到
where	where
美梦	美梦
最怕	最怕
平凡	平凡
队伍	队伍
威武	威武
唇膏	唇膏
花果	花果
涉及	涉及
运动	运动
周期	周期
前段时间	前段时间
最佳	最佳
个人很喜欢	个人很喜欢
播放	播放
一代	一代
保健	保健
爱婴	爱婴
报名	报名
想吐	想吐
消毒	消毒
热量	热量
吃饱	吃饱
没有用	没有用
南翔	南翔
after	after
深情	深情
谋杀	谋杀
lD	lD
疯抢	疯抢
这么美	这么美
代金券	代金券
教室	教室
六天	六天
开业	开业
晚上	晚上
活动	活动
第一眼	第一眼
成分	成分
衰老	衰老
stop	stop
幸福生活	幸福生活
标准的	标准的
三日	三日
中型	中型
小面包	小面包
style	style
尊重	尊重
pic	pic
老年人	老年人
航空	航空
稳重	稳重
深刻	深刻
万宁	万宁
意义	意义
同学们	同学们
服务质量差	服务质量差
沐浴露	沐浴露
国民	国民
克拉	克拉
热血	热血
风格	风格
礼仪	礼仪
一大早	一大早
比较实惠	比较实惠
上瘾	上瘾
补水	补水
大鸡排	大鸡排
岘港	岘港
使用心得	使用心得
炸鸡	炸鸡
苏宁易购	苏宁易购
质量很好	质量很好
你大爷	你大爷
忘记	忘记
AVE	AVE
变态	变态
华丽的	华丽的
him	him
Some	Some
不忘	不忘
据悉	据悉
@南方航空	@南方航空
标价	标价
实惠	实惠
花纹	花纹
德芙	德芙
国贸	国贸
Super	Super
公路	公路
春秋航空	春秋航空
机器	机器
KING	KING
气候	气候
心	心
雪佛兰	雪佛兰
忧伤	忧伤
大鸡	大鸡
DJ	DJ
吃鸡肉	吃鸡肉
店吧	店吧
值得信	值得信
过期	过期
心痛	心痛
欧尚	欧尚
圣诞礼物	圣诞礼物
站着	站着
醒的	醒的
UDI	UDI
基金	基金
好小	好小
超爱	超爱
肌肉	肌肉
生煎	生煎
加盟	加盟
小贵	小贵
包内	包内
ban	ban
开机	开机
规划	规划
一大片	一大片
风尚	风尚
素和	素和
辐射	辐射
线条	线条
比赛	比赛
狂吃	狂吃
轻轻	轻轻
中餐厅	中餐厅
艰难	艰难
苍蝇	苍蝇
百科	百科
减震	减震
吸收	吸收
小熊	小熊
老老实实	老老实实
宝和	宝和
该怎么办	该怎么办
清醒	清醒
教我	教我
小杨生煎	小杨生煎
好时	好时
两边	两边
牙齿	牙齿
母乳喂养	母乳喂养
点开	点开
中奖	中奖
鄙视	鄙视
後來	後來
背景	背景
日记	日记
从今	从今
购买	购买
摄于	摄于
Nexus	Nexus
植物	植物
约时	约时
认识的	认识的
小马	小马
交换	交换
进取	进取
彰显	彰显
品价	品价
暴力	暴力
尼泊	尼泊
sonic	sonic
一定要去	一定要去
OME	OME
一日游	一日游
户外用品	户外用品
售商	售商
Iv	Iv
Ok	Ok
葡萄	葡萄
起度	起度
NF	NF
案件	案件
结局	结局
品质	品质
加州	加州
质量太差	质量太差
睡不着	睡不着
发霉	发霉
高跟	高跟
烂片	烂片
颜色	颜色
毒奶粉	毒奶粉
吉隆坡-	吉隆坡-
狼爪	狼爪
体内	体内
大地	大地
节目	节目
鞋底	鞋底
早上起来	早上起来
解决方案	解决方案
第一次看	第一次看
彩色	彩色
蜂蜜	蜂蜜
真不是	真不是
沐浴	沐浴
抹茶	抹茶
寒冷	寒冷
打工	打工
鸡事件	鸡事件
量很好	量很好
好喝的	好喝的
美赞臣	美赞臣
沃尔玛	沃尔玛
价格便宜	价格便宜
孕期	孕期
两罐	两罐
台灣	台灣
特別	特別
温情	温情
实事	实事
港币	港币
不易	不易
作品	作品
告别	告别
没钱	没钱
常喜欢	常喜欢
幽默	幽默
盈利	盈利
期食	期食
缩水	缩水
获悉	获悉
红辣	红辣
闺女	闺女
见面	见面
百元	百元
如愿	如愿
全球	全球
步步	步步
很有效	很有效
联想	联想
欧赛轮	欧赛轮
国球	国球
铁	铁
西苑	西苑
杏仁	杏仁
被曝光	被曝光
翻译	翻译
迷人	迷人
小肥羊	小肥羊
制卡	制卡
沙拉	沙拉
庆王府	庆王府
汇信网	汇信网
办理证书	办理证书
延期	延期
变更	变更
优惠	优惠
找第一	找第一
凯美瑞	凯美瑞
礼服一件	礼服一件
送價值	送價值
九城	九城
在线办理	在线办理
有奖竞猜	有奖竞猜
店铺优惠	店铺优惠
再享	再享
乐山	乐山
内网络科	内网络科
免费	免费
沐足	沐足
联盟	联盟
塔内网络	塔内网络
拍照	拍照
发微博	发微博
会员	会员
一卡通	一卡通
广州塔内网	广州塔内网
台式	台式
请联系我	请联系我
天津嘉信	天津嘉信
南菱	南菱
塔内网络科	塔内网络科
内网络科技	内网络科技
全球联盟	全球联盟
联盟一卡通	联盟一卡通
拍照发微博	拍照发微博
買滿	買滿
大世纪	大世纪
优惠券可享	优惠券可享
惠推	惠推
台式料理	台式料理
天津恒大	天津恒大
欢迎到店	欢迎到店
恒大世纪	恒大世纪
宝悦行	宝悦行
礼包	礼包
南宝悦	南宝悦
微信	微信
公众平台	公众平台
车型上市	车型上市
底价	底价
试驾	试驾
世纪旅游城	世纪旅游城
最新优惠	最新优惠
新优惠活动	新优惠活动
房源	房源
礼相送	礼相送
即可享受	即可享受
零利	零利
可优惠	可优惠
万元优惠	万元优惠
更多优惠	更多优惠
二月二	二月二
尊享万元	尊享万元
欢迎来电	欢迎来电
梦幻海岸	梦幻海岸
独享优惠价	独享优惠价
冠军版	冠军版
空运	空运
包牌	包牌
全系车	全系车
名士	名士
婚纱	婚纱
优惠购	优惠购
影片	影片
婉美嫁衣	婉美嫁衣
假日润园	假日润园
临沂	临沂
细胞再生	细胞再生
澳际	澳际
车销售服	车销售服
IBANA	IBANA
KIBAN	KIBAN
乐居	乐居
IKIBA	IKIBA
MIKIB	MIKIB
金鹰家电	金鹰家电
商城	商城
经理签字价	经理签字价
招商银行	招商银行
赠票	赠票
骏业	骏业
汽车销售	汽车销售
销售服务	销售服务
购车礼	购车礼
敬请关注	敬请关注
曲歌	曲歌
丰庐	丰庐
宜家住宿	宜家住宿
蚝门烧烤	蚝门烧烤
易通	易通
有好礼	有好礼
广汽丰田	广汽丰田
如皋益昌	如皋益昌
丰田江丰	丰田江丰
仁参	仁参
港匯購	港匯購
塔内淘宝店	塔内淘宝店
呼伦贝尔	呼伦贝尔
丰庐山店	丰庐山店
贝亚克	贝亚克
Trip	Trip
Field	Field
VSM	VSM
江丰庐山店	江丰庐山店
普安	普安
塔内购	塔内购
宁夏银福	宁夏银福
焕颜	焕颜
瘦肉	瘦肉
胖的	胖的
右上	右上
肥羊	肥羊
难忘	难忘
贵州	贵州
馋嘴	馋嘴
头条博客	头条博客
颗粒	颗粒
最高优惠	最高优惠
汽车美容	汽车美容
乐融融	乐融融
山药	山药
洗脸	洗脸
酒水	酒水
tudio	tudio
棉衣	棉衣
其他优惠	其他优惠
店铺优惠券	店铺优惠券
油脂	油脂
超市	超市
相送	相送
全年	全年
Tina	Tina
尿不湿	尿不湿
下载附件	下载附件
lx	lx
魔法	魔法
半个小时	半个小时
目中	目中
贵阳	贵阳
车美	车美
餐品	餐品
歌手	歌手
来电咨询	来电咨询
优惠券	优惠券
欢迎	欢迎
半价优惠	半价优惠
edu	edu
白云	白云
便便	便便
豪大大	豪大大
美图秀秀	美图秀秀
Android	Android
港幣	港幣
二代	二代
好处	好处
操控	操控
爽肤水	爽肤水
万和	万和
味增	味增
登录	登录
丽萍	丽萍
部分车	部分车
便宜车	便宜车
广大客户	广大客户
您的光临	您的光临
天语	天语
海运	海运
销售高	销售高
苏宁广场	苏宁广场
上浮	上浮
轻点鼠标	轻点鼠标
酒礼	酒礼
快递	快递
小木马	小木马
迫不及待	迫不及待
申通	申通
大声	大声
纯净	纯净
唯美	唯美
宁夏	宁夏
裁判	裁判
特价机	特价机
购置税	购置税
大笑	大笑
简约	简约
食欲	食欲
感恩节	感恩节
上菜慢	上菜慢
洁面	洁面
有生	有生
吃奶	吃奶
紧致	紧致
大赛	大赛
生津	生津
时尚	时尚
年费	年费
北汽	北汽
面	面
销售	销售
星海	星海
均匀	均匀
保财险	保财险
商场	商场
金字	金字
追逐	追逐
儿时	儿时
一笔	一笔
哭了	哭了
喂养	喂养
后感	后感
子公司	子公司
力量	力量
区域	区域
里屯	里屯
报警	报警
aid	aid
精华	精华
may	may
必需	必需
不容错过哦	不容错过哦
IM	IM
越来越多	越来越多
中国南航	中国南航
牛肉	牛肉
诠释	诠释
获奖的	获奖的
OX	OX
采访	采访
华酒	华酒
探路	探路
锻炼	锻炼
屏幕	屏幕
进出口	进出口
吃惊	吃惊
比较多	比较多
高手	高手
房间	房间
资料	资料
浮云	浮云
离谱	离谱
太喜欢了	太喜欢了
五角	五角
驾驭	驾驭
不输	不输
被窝	被窝
盘点	盘点
眼泪	眼泪
计算	计算
韵味	韵味
菠菜	菠菜
blank	blank
南湖	南湖
North	North
时用	时用
下滑	下滑
湿的	湿的
嘴巴	嘴巴
兴隆	兴隆
油烟	油烟
答案	答案
曲径	曲径
日期	日期
三夫	三夫
本帮菜	本帮菜
新加坡航空	新加坡航空
全能	全能
产品	产品
other	other
差了点	差了点
当然	当然
怕不	怕不
好消息	好消息
Out	Out
朋友推荐	朋友推荐
女子	女子
大队	大队
力强	力强
米兰	米兰
保质期	保质期
苏果	苏果
经历	经历
切糕	切糕
油条	油条
box	box
花都	花都
爸爸	爸爸
详询	详询
陈凯霖	陈凯霖
Kath	Kath
受理	受理
五十	五十
衣服	衣服
有点像	有点像
五一	五一
向上	向上
冬日里	冬日里
水珠	水珠
丰满	丰满
冲锋	冲锋
待遇	待遇
富华	富华
開始	開始
羊毛	羊毛
情绪	情绪
战争	战争
外滩	外滩
大都汇	大都汇
穿梭	穿梭
主创	主创
掌柜	掌柜
fm	fm
分泌	分泌
最棒	最棒
一部分	一部分
地形	地形
艺术	艺术
包装	包装
顺利	顺利
逃离	逃离
去黑	去黑
招聘	招聘
字体	字体
德国	德国
没有发现	没有发现
太烂	太烂
味道	味道
柔的	柔的
新安	新安
冬季	冬季
失眠	失眠
景区门票	景区门票
大雨	大雨
姑娘	姑娘
栗子	栗子
基地	基地
地球	地球
主持人	主持人
身體	身體
出示	出示
值机	值机
丹麦	丹麦
盒子	盒子
休假	休假
rate	rate
激烈	激烈
通便	通便
低成本	低成本
出行日期	出行日期
情调	情调
金谊广场	金谊广场
相宜	相宜
盛宴	盛宴
琉璃	琉璃
记忆	记忆
汉堡王	汉堡王
开心	开心
同志们	同志们
生涯	生涯
融融	融融
暖意	暖意
抵用券一张	抵用券一张
女装	女装
四月	四月
路大	路大
应用程序	应用程序
浑然	浑然
腹泻	腹泻
粉丝们	粉丝们
吉珠	吉珠
我擦	我擦
差不说	差不说
中高	中高
通过携程	通过携程
月初	月初
有光	有光
阻止	阻止
社会	社会
构成	构成
质量怎么	质量怎么
公司	公司
天气好	天气好
标志	标志
中国风	中国风
中山路	中山路
浑身	浑身
打死	打死
划算	划算
想哭	想哭
两百	两百
分析	分析
特价票	特价票
用餐环境	用餐环境
大雪	大雪
爹	爹
粮食	粮食
防滑	防滑
寒冷的冬	寒冷的冬
旅游城	旅游城
动感	动感
梦里	梦里
优惠多多	优惠多多
外型	外型
发动机	发动机
隆重	隆重
宇宙	宇宙
全地	全地
国际机场	国际机场
匆匆	匆匆
抗力	抗力
动作	动作
平和	平和
保险	保险
拍照片	拍照片
店购	店购
瘦的	瘦的
年代	年代
渗透	渗透
tv	tv
背后	背后
一罐	一罐
喂奶	喂奶
买鞋	买鞋
英寸	英寸
快递公司	快递公司
心爱的	心爱的
色素	色素
定位	定位
来临	来临
安全的	安全的
小河	小河
超重	超重
有情	有情
运费	运费
我的最爱	我的最爱
贡献	贡献
年龄	年龄
金优惠	金优惠
旅行社	旅行社
王国	王国
两晚	两晚
天飞	天飞
鱼丸	鱼丸
优惠信息	优惠信息
jC	jC
敢吃	敢吃
身材	身材
好赞	好赞
夜晚	夜晚
过山	过山
总体评价	总体评价
聚美优品	聚美优品
喝多	喝多
蓝色	蓝色
啥时候	啥时候
礼物	礼物
真诚的	真诚的
合同	合同
大众	大众
没睡	没睡
不准	不准
水间	水间
伊森艾伦	伊森艾伦
张欣	张欣
世上	世上
诱惑	诱惑
攻略	攻略
获奖	获奖
香香	香香
前段	前段
饰品	饰品
高山	高山
坡航班	坡航班
大礼包	大礼包
电动	电动
折合	折合
恋爱	恋爱
迟到	迟到
马肉	马肉
橘子	橘子
广汽本田	广汽本田
够用	够用
留意	留意
现金优惠	现金优惠
超标	超标
顺畅	顺畅
土地	土地
前方	前方
帽衫	帽衫
瘦肉精	瘦肉精
亞洲航空	亞洲航空
悲剧的	悲剧的
面部	面部
年终	年终
护士	护士
库存	库存
从而	从而
笑容	笑容
泰国	泰国
真心不好用	真心不好用
犹如	犹如
吃鸡	吃鸡
中国	中国
知道	知道
撞死	撞死
many	many
质量	质量
纯棉	纯棉
售后电话	售后电话
乐友	乐友
真的很棒	真的很棒
服务	服务
运行	运行
功效	功效
养鸡	养鸡
HOLD住	HOLD住
整天	整天
模特	模特
直达	直达
建筑风格	建筑风格
光明	光明
新颖	新颖
骆驼	骆驼
较便宜	较便宜
太难	太难
速度	速度
石刻	石刻
大洋	大洋
應該	應該
究的	究的
签收	签收
刹车	刹车
含税	含税
村庄	村庄
帽子	帽子
高保湿	高保湿
取得	取得
改装	改装
抢劫	抢劫
两人	两人
特别适合	特别适合
尚未	尚未
喜欢它	喜欢它
彩电	彩电
大仙	大仙
树顶别墅	树顶别墅
高保	高保
商业	商业
老实	老实
来源	来源
太太	太太
谢谢	谢谢
喜欢	喜欢
轻柔	轻柔
有益	有益
无聊	无聊
添加剂	添加剂
学术	学术
人次	人次
有机会赢	有机会赢
外地	外地
万恶	万恶
伟大的	伟大的
基因	基因
很满足	很满足
不爽	不爽
小火	小火
很容易	很容易
事实上	事实上
度假村	度假村
日产	日产
避暑	避暑
简洁	简洁
更显	更显
很帅	很帅
主板	主板
HK	HK
餐馆	餐馆
历程	历程
喜歡	喜歡
地沟	地沟
自制	自制
气冷	气冷
OLAY	OLAY
亚洲廉航网	亚洲廉航网
杯具	杯具
像素	像素
索性	索性
附近	附近
最小	最小
款手	款手
孕妇	孕妇
足球	足球
天鹅	天鹅
展开	展开
境界	境界
未知	未知
累的	累的
增长	增长
不会变	不会变
极具	极具
扮演	扮演
轮滑协会	轮滑协会
毛巾	毛巾
和力	和力
will	will
赏花	赏花
想不到	想不到
柔软的	柔软的
空白	空白
服务质量	服务质量
概念	概念
咨询电话	咨询电话
一起做	一起做
花椒	花椒
搭载	搭载
廣州	廣州
快捷	快捷
表层	表层
下半年	下半年
提神	提神
青菜	青菜
增添	增添
羊羊	羊羊
篮球	篮球
三方	三方
Plan	Plan
不相信	不相信
咪咪	咪咪
忽略	忽略
出场	出场
客机	客机
唱歌	唱歌
抵抗力	抵抗力
浓度	浓度
步骤	步骤
阅读	阅读
行李	行李
价钱	价钱
进口	进口
第一次	第一次
鞋	鞋
小镇	小镇
宝贝	宝贝
高效	高效
行驶	行驶
有力	有力
放出	放出
流动	流动
三夫户外	三夫户外
中国足球	中国足球
睡眠	睡眠
本周末	本周末
打不通	打不通
上城	上城
价格	价格
维权	维权
粗犷	粗犷
生日	生日
营养	营养
bar	bar
中国电信	中国电信
原版	原版
动机	动机
密集	密集
踩着	踩着
要钱	要钱
按揭	按揭
音质	音质
圈圈	圈圈
无需	无需
永不	永不
三点	三点
本田	本田
大袋	大袋
听着	听着
生素	生素
超好的	超好的
很用	很用
飞航	飞航
单程含税	单程含税
火锅	火锅
有助	有助
即便	即便
男孩	男孩
垃圾食品	垃圾食品
泰式	泰式
副作用	副作用
入睡	入睡
比亚迪	比亚迪
代金	代金
垄断	垄断
百度	百度
豆豆	豆豆
印章	印章
发动	发动
无意	无意
弹性	弹性
包邮	包邮
彩虹	彩虹
小儿	小儿
三文鱼	三文鱼
去哪儿	去哪儿
视线	视线
牛初乳	牛初乳
主义	主义
干净的	干净的
年后	年后
地板	地板
廉航	廉航
光盘	光盘
大王	大王
精灵	精灵
软件	软件
详见	详见
最棒的	最棒的
值得拥有	值得拥有
网球	网球
好可爱	好可爱
微软	微软
好玩	好玩
外观	外观
论文	论文
alt	alt
豆包	豆包
画面	画面
划算的	划算的
人心	人心
酒廊	酒廊
景观	景观
痘痘	痘痘
麦片	麦片
地沟油	地沟油
运动的	运动的
饿死	饿死
自如	自如
性价比很高	性价比很高
活泼	活泼
滋养	滋养
角度	角度
单号	单号
赞美	赞美
去死	去死
驱车	驱车
纸巾	纸巾
摩擦	摩擦
一晚	一晚
开着	开着
原料	原料
买错	买错
争取	争取
新型	新型
浙江省	浙江省
永远的	永远的
目的地	目的地
行政	行政
丰胸	丰胸
马尔代夫	马尔代夫
戴上	戴上
内购	内购
山上	山上
Time	Time
uper	uper
des	des
八个	八个
沙发	沙发
拉风	拉风
回收	回收
手机	手机
发送	发送
阵容	阵容
国家	国家
价票	价票
传播	传播
下个	下个
各大超市	各大超市
范儿	范儿
痒痒	痒痒
亮点	亮点
哥伦比亚	哥伦比亚
草莓	草莓
鸡	鸡
润园	润园
喝下	喝下
好饿	好饿
领队	领队
给出	给出
体质	体质
珠宝	珠宝
食品安全	食品安全
材质	材质
巡回	巡回
头发	头发
监管	监管
IR	IR
侮辱	侮辱
小猪	小猪
心灵	心灵
兰卡	兰卡
协议	协议
最佳时	最佳时
京东商城	京东商城
海底捞	海底捞
爱喝	爱喝
展览	展览
装品	装品
细腻	细腻
点缀	点缀
躁的	躁的
美美的	美美的
礼服	礼服
一阵	一阵
看房	看房
维护	维护
回顾	回顾
效果不错	效果不错
海底	海底
好吃了	好吃了
优惠活动	优惠活动
宵夜	宵夜
宾客	宾客
日式料理	日式料理
逃逸	逃逸
广发信用卡	广发信用卡
小二	小二
灌篮	灌篮
体育馆	体育馆
男士	男士
港版	港版
错过	错过
基本都是	基本都是
多优惠	多优惠
事件调查	事件调查
趋势	趋势
时机	时机
兔	兔
香水	香水
完整	完整
一查	一查
大脑	大脑
比较	比较
杯子	杯子
安徽环球	安徽环球
推销	推销
国超	国超
精神	精神
租赁	租赁
紫色	紫色
人文	人文
好好看	好好看
甜点	甜点
将推出	将推出
直飞	直飞
廉价航空	廉价航空
门票	门票
淘宝	淘宝
大庆	大庆
添置	添置
孩子们	孩子们
新包	新包
快行动吧	快行动吧
广汽	广汽
气质	气质
东升	东升
安全	安全
各种	各种
客户端	客户端
晚上吃	晚上吃
大白菜	大白菜
镜头	镜头
态度好	态度好
少量	少量
老大	老大
在床上	在床上
这么差	这么差
set	set
iPad	iPad
QUECHUA	QUECHUA
看下	看下
带来了	带来了
自然	自然
怎么办	怎么办
香气	香气
喝酒	喝酒
亚航大促	亚航大促
差到爆	差到爆
曾经	曾经
折磨	折磨
阳和	阳和
国企	国企
醒来	醒来
城市	城市
非常感谢	非常感谢
武器	武器
车公	车公
沙巴	沙巴
馄饨	馄饨
净的	净的
凸显	凸显
道上	道上
最适合	最适合
甜蜜	甜蜜
好几个	好几个
户外装	户外装
会告诉你	会告诉你
面积	面积
食用	食用
好闻	好闻
视觉	视觉
很细	很细
雪花	雪花
一直觉得	一直觉得
纠结	纠结
兰博	兰博
极度	极度
欢乐	欢乐
玛特	玛特
双十一	双十一
首付	首付
百盛店	百盛店
见过	见过
人头	人头
莘庄	莘庄
亲和力	亲和力
这么贵	这么贵
痘印	痘印
嗓子	嗓子
脖子	脖子
内衣	内衣
轮子	轮子
计划	计划
湿地	湿地
不虚	不虚
动物园	动物园
不可能	不可能
kate	kate
登山	登山
很贵	很贵
本帖	本帖
百盛	百盛
怕你	怕你
结构	结构
BB	BB
届时	届时
都是我	都是我
唯有	唯有
煎	煎
精油	精油
物美价廉	物美价廉
系列	系列
手法	手法
态度差	态度差
超值优惠	超值优惠
往往	往往
David	David
国美	国美
专业	专业
在学	在学
多优	多优
过敏	过敏
新房	新房
一起玩	一起玩
friend	friend
洗手	洗手
显著	显著
不要脸	不要脸
马尔	马尔
路上	路上
效果好	效果好
很久没	很久没
推荐关注	推荐关注
好一点	好一点
上图	上图
少不了	少不了
吃完饭	吃完饭
一星	一星
超赞的	超赞的
WMF	WMF
aft	aft
艾伦	艾伦
辅助	辅助
定价	定价
西湖区	西湖区
本想	本想
车尾	车尾
国银	国银
球国	球国
一定会	一定会
神奇的	神奇的
好吃啊	好吃啊
太长	太长
节能	节能
过年了	过年了
帮他	帮他
深度	深度
深夜	深夜
支行	支行
特推出	特推出
TESCO	TESCO
踏青	踏青
Day	Day
小型	小型
药店	药店
已经开始	已经开始
aph	aph
主角	主角
五楼	五楼
陌生	陌生
硬的	硬的
滑坡	滑坡
责任追究	责任追究
各位	各位
东路	东路
ken	ken
生成	生成
信用卡	信用卡
不给退	不给退
食品	食品
日子	日子
精彩	精彩
Hr	Hr
小盆	小盆
good	good
措施	措施
设计	设计
纤维	纤维
求解	求解
系统	系统
希望大家	希望大家
驾驶	驾驶
回味	回味
粉的	粉的
感觉到	感觉到
为毛	为毛
妈呀	妈呀
长隆	长隆
目标	目标
要考虑	要考虑
是要闹哪样	是要闹哪样
和朋友	和朋友
持久	持久
面料	面料
可享受	可享受
可达	可达
北美	北美
家的服务	家的服务
莫干山路	莫干山路
婴儿	婴儿
有品	有品
最难	最难
其他地方	其他地方
一块钱	一块钱
布丁	布丁
三墩	三墩
最开心	最开心
大卖场	大卖场
不经	不经
多服务	多服务
佳能	佳能
防止	防止
不行了	不行了
国足	国足
智能手机	智能手机
凯美	凯美
原文	原文
好美	好美
马自达	马自达
很棒	很棒
ph	ph
方案	方案
路交叉口	路交叉口
年旅	年旅
演绎	演绎
性价比高	性价比高
消息	消息
不愿意	不愿意
本航	本航
只剩	只剩
天回	天回
大箱	大箱
南方	南方
翻出来	翻出来
早上起	早上起
学会	学会
抬头	抬头
知道它	知道它
日货	日货
想我	想我
价商	价商
ATE	ATE
银行信用卡	银行信用卡
四十	四十
两位	两位
移动电源	移动电源
更新	更新
南风	南风
UV	UV
慷慨	慷慨
快餐	快餐
乐购仕	乐购仕
公斤	公斤
公寓	公寓
家庭影院	家庭影院
大叔	大叔
非常方便	非常方便
也不要	也不要
户外	户外
ough	ough
有点儿	有点儿
性价比	性价比
山西	山西
即将到来	即将到来
戒了	戒了
深圳市	深圳市
街头	街头
肥皂	肥皂
华丽	华丽
液体	液体
抓狂	抓狂
惬意	惬意
氛围	氛围
大力	大力
金沙	金沙
害羞	害羞
做饭	做饭
有变	有变
跑道	跑道
教主	教主
对待	对待
DMK	DMK
马来西亚	马来西亚
定期直飞	定期直飞
广西南宁	广西南宁
试试看	试试看
粉刺	粉刺
路南	路南
印象	印象
福啊	福啊
旅途	旅途
三峡	三峡
消费者	消费者
度差	度差
鸡肉	鸡肉
脑残	脑残
定金	定金
read	read
登场	登场
元素	元素
舒缓	舒缓
亚洲航空	亚洲航空
骑马	骑马
不痛	不痛
想看	想看
梦想的	梦想的
玩的	玩的
伤害	伤害
百花	百花
差劲的	差劲的
举办的	举办的
太平洋	太平洋
晒晒	晒晒
即将	即将
本质	本质
ppi	ppi
质问	质问
鸡蛋	鸡蛋
说的是	说的是
输给	输给
睡觉的	睡觉的
英雄	英雄
抵用	抵用
冰糖	冰糖
损失	损失
衣物	衣物
目的	目的
alu	alu
逛超市	逛超市
出发的	出发的
接下来	接下来
鲜奶	鲜奶
四季酒店	四季酒店
sb	sb
鲜嫩	鲜嫩
粉红	粉红
世界末日	世界末日
乐购	乐购
答应	答应
合作	合作
跑步	跑步
不错	不错
尺寸	尺寸
影讯	影讯
北斗	北斗
PINK	PINK
华美	华美
并不是	并不是
潮人	潮人
熟的	熟的
收购	收购
后面的	后面的
在国内	在国内
带着它	带着它
找到一家	找到一家
房的风格	房的风格
收入	收入
依然	依然
颇低	颇低
辗转	辗转
铁艺	铁艺
四个住处	四个住处
拷贝	拷贝
又加入自己	又加入自己
铁艺床	铁艺床
加入自己	加入自己
两座城市	两座城市
自己的喜好	自己的喜好
此后	此后
一款铁艺	一款铁艺
成功	成功
如今	如今
无法购买	无法购买
依然带着	依然带着
换了新房	换了新房
主卧	主卧
次卧	次卧
客房	客房
铁艺的	铁艺的
依然带着它	依然带着它
为了新房	为了新房
当时的收入	当时的收入
新房的风格	新房的风格
喜好	喜好
画图定做	画图定做
非常吸引	非常吸引
找到	找到
款式	款式
变了颜色	变了颜色
放过	放过
绘画	绘画
差异	差异
场景	场景
one	one
劣质	劣质
赶上	赶上
广州	广州
该死	该死
绚丽	绚丽
教练	教练
生活中	生活中
鞋面	鞋面
自助早餐	自助早餐
十分的	十分的
可能	可能
大礼	大礼
户外装备	户外装备
没开	没开
真的很好用	真的很好用
百思买	百思买
LCCT	LCCT
从小	从小
南北	南北
长假	长假
真心不好	真心不好
心得	心得
春季	春季
医院	医院
亚航之家	亚航之家
圆满	圆满
大客户	大客户
品鉴	品鉴
玫瑰	玫瑰
费会	费会
世嘉	世嘉
元/人	元/人
毕业	毕业
单程	单程
最便宜	最便宜
长度	长度
应该	应该
免费换	免费换
智能	智能
预防	预防
托运	托运
质量好	质量好
旅程	旅程
最适	最适
啥时	啥时
此时	此时
湿了	湿了
糖	糖
明儿	明儿
高温	高温
太贵	太贵
have	have
圭贤	圭贤
有肉	有肉
周三	周三
旅行	旅行
环球旅行	环球旅行
菜价	菜价
白菜	白菜
热情	热情
自主	自主
年头	年头
源于	源于
海	海
座椅	座椅
配方	配方
非常满意	非常满意
山地	山地
假	假
哥们	哥们
宠物	宠物
重要	重要
泥马	泥马
老化	老化
稳定	稳定
非常	非常
下降	下降
处女	处女
有效	有效
游客	游客
玻璃	玻璃
周到	周到
时报	时报
激动	激动
少年	少年
起飞	起飞
家	家
太差	太差
备受	备受
成绩	成绩
class	class
年前	年前
self	self
意识	意识
存储	存储
橙子	橙子
山体滑坡	山体滑坡
night	night
平板	平板
即日起	即日起
可以免费	可以免费
配套	配套
功率	功率
溃疡	溃疡
大亚	大亚
一汽	一汽
柠檬	柠檬
bv	bv
倒霉	倒霉
双十	双十
电池	电池
名单	名单
买票	买票
多吃	多吃
芦荟	芦荟
不舍	不舍
内心	内心
小盆友	小盆友
有心	有心
杀人	杀人
航空公司	航空公司
这年头	这年头
导游	导游
伊森	伊森
心仪	心仪
缓解	缓解
时间	时间
心跳	心跳
清凉	清凉
好地方	好地方
安卓	安卓
修改	修改
平衡	平衡
改变	改变
西昌	西昌
五星酒店	五星酒店
低调	低调
训练	训练
期限	期限
嗷嗷	嗷嗷
究渐无音	究渐无音
塑化剂	塑化剂
责任	责任
渐无音讯	渐无音讯
调查	调查
雾里看花	雾里看花
无音讯	无音讯
矿难瞒报	矿难瞒报
抽检	抽检
农业部	农业部
矿难	矿难
You	You
off	off
指望	指望
和好	和好
没电	没电
好看的	好看的
专业版微博	专业版微博
来自专业版	来自专业版
专业版	专业版
话费	话费
不容错过	不容错过
终于	终于
北极	北极
龙	龙
小清新	小清新
奶酪	奶酪
表示	表示
户外运动	户外运动
自己看	自己看
商品	商品
爱	爱
喜欢这样	喜欢这样
堵车	堵车
hing	hing
ull	ull
美容院	美容院
long	long
一起	一起
oto	oto
ipa	ipa
趣岳	趣岳
機票	機票
如家	如家
mber	mber
四季	四季
一个半小时	一个半小时
用餐	用餐
西街	西街
可爱	可爱
年末	年末
廊曼机场	廊曼机场
湖畔	湖畔
咖啡	咖啡
Ben	Ben
媒体报道	媒体报道
矿	矿
事故责任	事故责任
孩子	孩子
优品	优品
输出	输出
人保	人保
西子湖畔	西子湖畔
真心喜欢	真心喜欢
钱	钱
有趣	有趣
魅力	魅力
奇葩	奇葩
光滑	光滑
西红柿	西红柿
水分	水分
赶脚	赶脚
年夏	年夏
bor	bor
AO	AO
小宝贝	小宝贝
最畅销	最畅销
论坛	论坛
各类	各类
糖果	糖果
车子	车子
不错哦	不错哦
慢	慢
香味	香味
花生	花生
oug	oug
留着	留着
回头	回头
ile	ile
满	满
排队	排队
随和	随和
向右转	向右转
卡	卡
超差	超差
暂时	暂时
冒着	冒着
代价	代价
两小时	两小时
靓丽	靓丽
专利	专利
行走	行走
淡淡的	淡淡的
次日	次日
抵御	抵御
签约	签约
实验	实验
之后	之后
Wang	Wang
暖暖	暖暖
很厚	很厚
一班	一班
艺术家	艺术家
sala	sala
夕阳	夕阳
愿意	愿意
sn	sn
证书	证书
bla	bla
妹妹	妹妹
onn	onn
计时	计时
二个	二个
即日	即日
大爱	大爱
大家	大家
亞洲	亞洲
古代	古代
菜	菜
VP	VP
今天	今天
尊享	尊享
发信	发信
手信	手信
闲置	闲置
nig	nig
进口奶粉	进口奶粉
上乘	上乘
资生堂	资生堂
透明	透明
还有很多	还有很多
有奖	有奖
杭州四季酒	杭州四季酒
第一次来	第一次来
不解	不解
下雪	下雪
店家	店家
go	go
神经病	神经病
晒单	晒单
症状	症状
女人	女人
巨大的	巨大的
海岸	海岸
这辈子	这辈子
商户	商户
自己	自己
进口奶	进口奶
师傅	师傅
老板	老板
浪漫的	浪漫的
自己家	自己家
即时	即时
送给我	送给我
上海市	上海市
结果	结果
速生鸡事件	速生鸡事件
国内的	国内的
自带	自带
繁华	繁华
另一个	另一个
全世界	全世界
spo	spo
相信	相信
服務	服務
纪录	纪录
Kat	Kat
作业	作业
穿越	穿越
land	land
绝对的	绝对的
終於	終於
上传	上传
入门	入门
减	减
价廉	价廉
配置	配置
第一个	第一个
大气	大气
Skate	Skate
cou	cou
夯土	夯土
开通	开通
态度	态度
made	made
jx	jx
rport	rport
fer	fer
好奇	好奇
ori	ori
航线	航线
bl	bl
赤裸	赤裸
Va	Va
hris	hris
农药	农药
真相	真相
ndi	ndi
不小心	不小心
传递	传递
Pre	Pre
专属	专属
AIRAS	AIRAS
RASIA	RASIA
雅阁	雅阁
传统	传统
买	买
有感觉	有感觉
贵	贵
一开始	一开始
arb	arb
马甲	马甲
风衣	风衣
吸引	吸引
白天	白天
日元	日元
我的手	我的手
了几	了几
解决	解决
给予	给予
重视	重视
地铁站	地铁站
担忧	担忧
长春	长春
ker	ker
fle	fle
皮质	皮质
结果显示	结果显示
fb	fb
分享	分享
好无聊	好无聊
bea	bea
大师	大师
一站	一站
戴着	戴着
ugh	ugh
ways	ways
大豆	大豆
ceb	ceb
图文	图文
四点	四点
小笼	小笼
过年	过年
這個	這個
你喜欢	你喜欢
大脸	大脸
婴儿奶粉	婴儿奶粉
东京	东京
not	not
业绩	业绩
LAY	LAY
办卡	办卡
同步	同步
药物	药物
emo	emo
athl	athl
认知	认知
过多	过多
暴走	暴走
今日	今日
牵手	牵手
版本	版本
携程	携程
礼拜	礼拜
南门	南门
Miss	Miss
首尔	首尔
充实	充实
A+	A+
今晚	今晚
结束	结束
三年	三年
翻出	翻出
促销活动	促销活动
ria	ria
第一	第一
流水	流水
低温	低温
正面	正面
呵护	呵护
最贵的	最贵的
爽了	爽了
二手	二手
昨天	昨天
笔	笔
停留	停留
很轻	很轻
粗糙	粗糙
淡的	淡的
浓缩	浓缩
yC	yC
两包	两包
Davi	Davi
中国银行	中国银行
tter	tter
白菜价	白菜价
礼盒	礼盒
upe	upe
体验	体验
亮相	亮相
arg	arg
IB	IB
外表	外表
一句话	一句话
sion	sion
易购	易购
夏天	夏天
态度恶劣	态度恶劣
三八节	三八节
银行	银行
凯德	凯德
毒奶	毒奶
法式	法式
GU	GU
arr	arr
霸气	霸气
看书	看书
Cap	Cap
一年	一年
违规	违规
单纯的	单纯的
没货	没货
线网	线网
推荐	推荐
早睡	早睡
西南	西南
坏掉	坏掉
早日	早日
电视	电视
画的	画的
体验中心	体验中心
江南风	江南风
岛	岛
项目	项目
同一个	同一个
向左	向左
装饰	装饰
东西	东西
come	come
这个价格	这个价格
四核	四核
跳舞	跳舞
不宜	不宜
L码	L码
上当	上当
电梯	电梯
中国人	中国人
客服热线	客服热线
五月	五月
忠实	忠实
八点	八点
那么贵	那么贵
特尔	特尔
海信	海信
文鱼	文鱼
增强	增强
UEC	UEC
八月	八月
华为	华为
代替	代替
准备	准备
西安	西安
优惠价	优惠价
辣妈	辣妈
管制	管制
欧元	欧元
初乳	初乳
音乐	音乐
机位	机位
亲手	亲手
能源	能源
腐败	腐败
车牌	车牌
餐	餐
折叠	折叠
会员日	会员日
地图	地图
拍出	拍出
同学	同学
不合格	不合格
清洁	清洁
友情	友情
带回来	带回来
大优惠	大优惠
公告	公告
波特	波特
新发现	新发现
最后的	最后的
差劲	差劲
杭州四季	杭州四季
订车	订车
热点事件	热点事件
累计	累计
部位	部位
好吃	好吃
招待	招待
质疑	质疑
轮胎	轮胎
家乐福	家乐福
帮帮	帮帮
群众	群众
电子	电子
穿上	穿上
比较喜欢	比较喜欢
有一套	有一套
抗生素	抗生素
满意	满意
指标	指标
施华洛	施华洛
花心	花心
She	She
比例	比例
流溢	流溢
正常使用	正常使用
客户	客户
肉松	肉松
没有之一	没有之一
心爱	心爱
先到先得	先到先得
女孩子	女孩子
中意	中意
小店	小店
机会	机会
热爱	热爱
回应	回应
在哪儿	在哪儿
给我吃	给我吃
细心	细心
仅售	仅售
锅里	锅里
吃火	吃火
CR	CR
头条	头条
菜品	菜品
装潢	装潢
车销	车销
航机	航机
银泰	银泰
不容易	不容易
坐着	坐着
玉兰	玉兰
无处	无处
PV	PV
孤独	孤独
小站	小站
活力	活力
金币	金币
赔偿	赔偿
儿子	儿子
如同	如同
过于	过于
卡卡	卡卡
一个人	一个人
悲催	悲催
小包	小包
震撼	震撼
透露	透露
big	big
半小时	半小时
自由行	自由行
赢家	赢家
差远了	差远了
保养	保养
广发	广发
DS	DS
仅有	仅有
在京	在京
转了一圈	转了一圈
不便宜	不便宜
吃完了	吃完了
会用	会用
风日	风日
登机	登机
女儿	女儿
方向	方向
在那里	在那里
地面	地面
拍卖	拍卖
中兴	中兴
天气	天气
又一次	又一次
上线	上线
其余	其余
好友	好友
江南	江南
区别	区别
丫头	丫头
格力	格力
写真	写真
know	know
红包	红包
金额	金额
MF	MF
tom	tom
联系方式	联系方式
伤心	伤心
一时间	一时间
能力	能力
一遍	一遍
喜来登	喜来登
不提	不提
西路	西路
臭豆腐	臭豆腐
贷款	贷款
洗发	洗发
蝴蝶	蝴蝶
一律	一律
眼前	眼前
手续费	手续费
墙上	墙上
粉红色	粉红色
护照	护照
疲劳	疲劳
熬夜	熬夜
记住	记住
人类	人类
昨天晚上	昨天晚上
平面	平面
常常	常常
对手	对手
人民币	人民币
店面	店面
关税	关税
发帖	发帖
清除	清除
需求	需求
家服	家服
独自	独自
真实的	真实的
好带	好带
生命	生命
应用商店	应用商店
产品质量	产品质量
到家	到家
聪明	聪明
寂寞	寂寞
春秋	春秋
错过了	错过了
多样	多样
pm	pm
注册	注册
羽绒服	羽绒服
增值	增值
熊猫	熊猫
用途	用途
趣岳中国	趣岳中国
美妙	美妙
真诚	真诚
三瓶	三瓶
在外面	在外面
一支	一支
白色的	白色的
严格	严格
台电	台电
Baby	Baby
附件	附件
高清	高清
车都	车都
绒服	绒服
车保	车保
大的	大的
他们家	他们家
意图	意图
买单	买单
飞机上	飞机上
接触	接触
望远	望远
汉堡	汉堡
中国好	中国好
华润	华润
典雅	典雅
猪肉	猪肉
逐渐	逐渐
食堂	食堂
品尝	品尝
科学	科学
合影	合影
前提	前提
料理	料理
海拔	海拔
创业	创业
请问	请问
活动期间	活动期间
人体	人体
西班牙	西班牙
感情	感情
可以联系	可以联系
勇气	勇气
作为一个	作为一个
满满	满满
高铁	高铁
泡泡	泡泡
忽悠	忽悠
靠谱	靠谱
消除	消除
大约	大约
合资	合资
熟悉	熟悉
原味	原味
代理	代理
强制	强制
隔音	隔音
悲伤	悲伤
疾病	疾病
首都	首都
App	App
往返	往返
更差	更差
RP	RP
还是吃	还是吃
觉得	觉得
冲动	冲动
用完	用完
冬天	冬天
热点	热点
Lee	Lee
客服电话	客服电话
价格优惠	价格优惠
心态	心态
楼下的	楼下的
泰安	泰安
防盗	防盗
嘻嘻	嘻嘻
主持	主持
sell	sell
轻便	轻便
货架	货架
专享	专享
胶囊	胶囊
亚克	亚克
羽毛球	羽毛球
酒楼	酒楼
通航	通航
民工	民工
庭院	庭院
抵制	抵制
酒会	酒会
骑车	骑车
Face	Face
方法	方法
表情	表情
教程	教程
听闻	听闻
UA	UA
刷卡	刷卡
欢迎大家	欢迎大家
地震	地震
展厅	展厅
肯定	肯定
柚子	柚子
吓死	吓死
天然	天然
装逼	装逼
亚洲最大	亚洲最大
小小的	小小的
成都	成都
活着	活着
小飞	小飞
不肯	不肯
物有所值	物有所值
社区	社区
预售	预售
一股	一股
试下	试下
游泳	游泳
这个价	这个价
吃到了	吃到了
要求退	要求退
停车场	停车场
答复	答复
想吃	想吃
秘密	秘密
我喜欢的	我喜欢的
最优	最优
电商	电商
父母	父母
性能	性能
上手	上手
早知	早知
起來	起來
好好吃	好好吃
高速	高速
回想	回想
八十	八十
日系	日系
好漂亮	好漂亮
配送	配送
口碑	口碑
人抢	人抢
家当	家当
鼻子	鼻子
事后	事后
冲击	冲击
婚礼	婚礼
rmb	rmb
人工	人工
物美	物美
双卡双待	双卡双待
方式	方式
重复	重复
服务人员	服务人员
新西兰	新西兰
公益	公益
菜馆	菜馆
诱人	诱人
活的	活的
自助餐	自助餐
收到	收到
小样	小样
害怕	害怕
屈臣氏	屈臣氏
BD	BD
有优惠	有优惠
时间内	时间内
爷的	爷的
好礼	好礼
越多	越多
网络	网络
加热	加热
分期	分期
买多	买多
一级棒	一级棒
最好的	最好的
很可爱	很可爱
雪山	雪山
听过	听过
拥抱	拥抱
查看大图	查看大图
排行	排行
右边	右边
线下	线下
光临	光临
温水	温水
周立波	周立波
购物中心	购物中心
宽带	宽带
过大	过大
明白	明白
处理器	处理器
喝茶	喝茶
软的	软的
时代	时代
到最后	到最后
there	there
男生	男生
不會	不會
不好	不好
内地	内地
新村	新村
终于吃到	终于吃到
不负	不负
很失望	很失望
各方面	各方面
坏的	坏的
力度	力度
状态	状态
第七	第七
珠江	珠江
穷人	穷人
全的	全的
华山	华山
忐忑	忐忑
限购	限购
蛋黄	蛋黄
十八	十八
开始了	开始了
要花	要花
Art	Art
北方	北方
被曝	被曝
车网	车网
五天	五天
理想	理想
温州	温州
抓绒	抓绒
Pad	Pad
尽在	尽在
不满意	不满意
Car	Car
高科技	高科技
独特	独特
不仅仅	不仅仅
吸引我	吸引我
舞蹈	舞蹈
听不	听不
巴厘岛	巴厘岛
清幽	清幽
复古	复古
pos	pos
求助	求助
海鲜	海鲜
回归	回归
天蝎座	天蝎座
有爱	有爱
住院	住院
裸心	裸心
新活动	新活动
上架	上架
大润发买	大润发买
三小时	三小时
抵抗	抵抗
实物	实物
股票	股票
快来看看	快来看看
旅馆	旅馆
坑人	坑人
很重要	很重要
夫人	夫人
右转	右转
美甲	美甲
不动	不动
长虹	长虹
海市	海市
默默	默默
毫升	毫升
大宝	大宝
VC	VC
很香	很香
续费	续费
beef	beef
事件中	事件中
讨价	讨价
很方便	很方便
Star	Star
别买	别买
海尔	海尔
皮的	皮的
珍惜	珍惜
衣服质量	衣服质量
Ex	Ex
BM	BM
转过	转过
雕工	雕工
妈咪	妈咪
洗完	洗完
HD	HD
用料	用料
不太好	不太好
便宜的	便宜的
哪里有	哪里有
屋企	屋企
跟着我	跟着我
top	top
大包	大包
一箱	一箱
发型	发型
语音	语音
指甲	指甲
world	world
退房	退房
有特色	有特色
五折	五折
提出	提出
没有好	没有好
美	美
一两	一两
还不如	还不如
突然觉得	突然觉得
风味	风味
家中	家中
大方	大方
到期	到期
牛肉汉堡	牛肉汉堡
优势	优势
生在	生在
FL	FL
理我	理我
我以为	我以为
围绕	围绕
镜子	镜子
耐用	耐用
奇怪	奇怪
国人	国人
公主	公主
偏高	偏高
路线	路线
走你	走你
童年	童年
穷游	穷游
多么	多么
绝对不	绝对不
邮政	邮政
還有	還有
将到来的	将到来的
抗氧化	抗氧化
为此	为此
伟大	伟大
级别	级别
又开始	又开始
一般人	一般人
尚的	尚的
脑子	脑子
怪我	怪我
床房	床房
货物	货物
喝水	喝水
远足	远足
吹风	吹风
只有一个	只有一个
别说	别说
欣慰	欣慰
姥姥	姥姥
退款	退款
暑假	暑假
冬日	冬日
装备	装备
自我	自我
好点	好点
比较适合	比较适合
防水	防水
至中国	至中国
刷新	刷新
将到	将到
赠品	赠品
安静	安静
解决问题	解决问题
电脑	电脑
码头	码头
明显	明显
觉到	觉到
乐蜂	乐蜂
粉质	粉质
桌上	桌上
有消息	有消息
TC	TC
创意	创意
避免	避免
随心	随心
曝光	曝光
地理位置	地理位置
排行榜	排行榜
粉和	粉和
life	life
包包	包包
ml	ml
有钱	有钱
黄油	黄油
水果	水果
别让	别让
隔壁	隔壁
超级便宜	超级便宜
uC	uC
焦虑	焦虑
UP	UP
深的	深的
不应	不应
亚太	亚太
爱上	爱上
返利	返利
雪人	雪人
很满	很满
限量	限量
一包	一包
澳门	澳门
换回	换回
混乱	混乱
家菜	家菜
年中	年中
硬件	硬件
shop	shop
AG	AG
沸腾	沸腾
西溪湿地	西溪湿地
洋家乐	洋家乐
难看	难看
园林	园林
常州	常州
赶到	赶到
太喜欢	太喜欢
交规	交规
BU	BU
只能说	只能说
鼠标	鼠标
战斗	战斗
道歉	道歉
厚实	厚实
阶段	阶段
农村	农村
济南	济南
秀丽	秀丽
玩笑	玩笑
不留	不留
做事	做事
均可	均可
汇率	汇率
智商	智商
一线	一线
出生	出生
能量	能量
工商	工商
赶紧的	赶紧的
十分钟	十分钟
场面	场面
日式	日式
别错过	别错过
榴莲	榴莲
SK	SK
惊喜	惊喜
竞争	竞争
突然想起	突然想起
最美的	最美的
俺们	俺们
相当的	相当的
about	about
健康	健康
酱油	酱油
天能	天能
乐购店	乐购店
有无	有无
屁颠	屁颠
哪儿	哪儿
名为	名为
优先	优先
流畅	流畅
谷歌	谷歌
山寨	山寨
住宅	住宅
客栈	客栈
卓越	卓越
ped	ped
小时候	小时候
家族	家族
质感	质感
车市	车市
羊肉	羊肉
蛋白	蛋白
赞一个	赞一个
国风	国风
图案	图案
和谐	和谐
环保	环保
东莞	东莞
sea	sea
密码	密码
GOOGLE	GOOGLE
做法	做法
公众	公众
详情	详情
服务真	服务真
双待	双待
还送了	还送了
deal	deal
游网	游网
放大	放大
很差	很差
欢迎您	欢迎您
傻逼	傻逼
不停	不停
错误	错误
谢谢你	谢谢你
万元	万元
诞生	诞生
大床	大床
公平	公平
人才	人才
国好	国好
数字影院	数字影院
出租	出租
里加	里加
未发	未发
空客	空客
太美了	太美了
成员	成员
十万	十万
居家	居家
触摸	触摸
引导	引导
刀具	刀具
放下	放下
化剂	化剂
NB	NB
测试	测试
合适	合适
穿衣	穿衣
表演	表演
总的来说	总的来说
绿色	绿色
意大利	意大利
羡慕	羡慕
途径	途径
九阳	九阳
不熟	不熟
说说	说说
肉汉堡	肉汉堡
猫头	猫头
刚刚	刚刚
白的	白的
可怜的	可怜的
退货	退货
补充	补充
我爱你	我爱你
air	air
重点是	重点是
此前	此前
没有什么	没有什么
亚洲	亚洲
别克	别克
天河	天河
网上购买	网上购买
非常的	非常的
酒吧	酒吧
非常适合	非常适合
前看	前看
大牌	大牌
热水器	热水器
百块	百块
变得	变得
原来我	原来我
大便	大便
游玩	游玩
一天都	一天都
水上	水上
注定	注定
不得不说	不得不说
修理	修理
感觉不错	感觉不错
服装品牌	服装品牌
男人	男人
一篇	一篇
常适合	常适合
既然	既然
学院	学院
has	has
微笑	微笑
华润万家	华润万家
赞助	赞助
抵用券	抵用券
五年	五年
再见	再见
感叹	感叹
隐藏	隐藏
强的	强的
穷游网	穷游网
乐蜂网	乐蜂网
独享	独享
坐落	坐落
笔记本	笔记本
追究	追究
扫货	扫货
有售	有售
看清	看清
订单	订单
万家	万家
川菜	川菜
清迈	清迈
全套	全套
奖品	奖品
怀孕	怀孕
便利	便利
老虎	老虎
粉丝	粉丝
官方网站	官方网站
名称	名称
下面	下面
极致	极致
牛皮	牛皮
餐饮	餐饮
有限公司	有限公司
按摩	按摩
房间卫生	房间卫生
促进	促进
虽然不	虽然不
毛球	毛球
带回	带回
胳膊	胳膊
值得推荐	值得推荐
车场	车场
浓郁	浓郁
小龙	小龙
act	act
人多	人多
现代	现代
普吉岛	普吉岛
总会	总会
活动中	活动中
警方	警方
ZA	ZA
雪地	雪地
观看	观看
第三次	第三次
还记得	还记得
太开心	太开心
无穷	无穷
美观	美观
高中	高中
超强	超强
超值的	超值的
含有	含有
山体	山体
尼玛	尼玛
小礼	小礼
换货	换货
也很不错	也很不错
以外	以外
主打	主打
多谢	多谢
极限	极限
金牛	金牛
鞍山	鞍山
各式	各式
机场	机场
爱车	爱车
点事	点事
坐下	坐下
博客	博客
反馈	反馈
包好	包好
半月	半月
被告知	被告知
方便	方便
上菜	上菜
办好	办好
ape	ape
请联系	请联系
个价	个价
干了	干了
岛上	岛上
数码	数码
保修	保修
检测	检测
周围	周围
季度	季度
消失	消失
美元	美元
美景	美景
下雨天	下雨天
表达	表达
十点	十点
自信	自信
气势	气势
杭州西子	杭州西子
活動	活動
东南亚	东南亚
LCC	LCC
设有	设有
GI	GI
一季	一季
九寨沟	九寨沟
光顾	光顾
才气	才气
北区	北区
部门	部门
快要	快要
腾讯	腾讯
相同	相同
pen	pen
三名	三名
看过	看过
两枚	两枚
古老	古老
稻香	稻香
拥有	拥有
MG	MG
细致	细致
山谷	山谷
忙碌	忙碌
鞋子	鞋子
水洗	水洗
典型	典型
真TM	真TM
卫生	卫生
服务设施	服务设施
设施设备	设施设备
周边环境	周边环境
酒店服务	酒店服务
更多评价	更多评价
购优惠	购优惠
扩散	扩散
part	part
四星	四星
即享	即享
除外	除外
鸡腿	鸡腿
花钱	花钱
关注我	关注我
收获	收获
可乐	可乐
护发素	护发素
潮流	潮流
车辆	车辆
余杭	余杭
集体	集体
极差	极差
博物馆	博物馆
二月	二月
联通	联通
环节	环节
超低	超低
恶心的	恶心的
末日	末日
太美	太美
营业厅	营业厅
身体	身体
太高	太高
烂的	烂的
热线	热线
最爱	最爱
寿司	寿司
请私信	请私信
体育	体育
辉煌	辉煌
耐心	耐心
电信	电信
政治	政治
花开	花开
纯的	纯的
咋办	咋办
山地运动	山地运动
好味	好味
到极	到极
丰田	丰田
加强	加强
影城	影城
舒适的	舒适的
您好	您好
乐享	乐享
出手	出手
探索	探索
青年	青年
遇见	遇见
问题	问题
布置	布置
爱心	爱心
涨价了	涨价了
帅气	帅气
特卖	特卖
精细	精细
去住	去住
红豆	红豆
查查	查查
王府	王府
九寨	九寨
现货	现货
拨打	拨打
音效	音效
kg	kg
点评	点评
好开心	好开心
理会	理会
认识	认识
档次	档次
笔记	笔记
暖和	暖和
too	too
挺不错的	挺不错的
快来看	快来看
拉着	拉着
啤酒	啤酒
自动	自动
垃圾	垃圾
最贵	最贵
点餐	点餐
海滩	海滩
证实	证实
讲座	讲座
FW	FW
卫浴	卫浴
敬请	敬请
不平	不平
晚点	晚点
性和	性和
行业	行业
冷的	冷的
因为	因为
所值	所值
进行	进行
生长	生长
忙的	忙的
十大	十大
全攻略	全攻略
我最爱的	我最爱的
下场	下场
一级	一级
问你	问你
语言	语言
多评	多评
凉爽	凉爽
新车	新车
CM	CM
Dr	Dr
运用	运用
路虎	路虎
抓住	抓住
cs	cs
给自己	给自己
安缦法云店	安缦法云店
优点	优点
原单	原单
受伤	受伤
最快	最快
后天	后天
谣言	谣言
菜市场	菜市场
酒店	酒店
巴士	巴士
女的	女的
三人	三人
事业	事业
超越	超越
激情	激情
有效期	有效期
陶瓷	陶瓷
开张	开张
静静	静静
可以买到	可以买到
不通	不通
他们说	他们说
偷懒	偷懒
等什么	等什么
呈现	呈现
必胜	必胜
都不好	都不好
车车	车车
在等	在等
室内设计	室内设计
有一次	有一次
走走	走走
dog	dog
oL	oL
流量	流量
接收	接收
口袋	口袋
让我想起	让我想起
注了	注了
ead	ead
们那	们那
出了一	出了一
用手	用手
创作	创作
珠海	珠海
可以再	可以再
水了	水了
py	py
老了	老了
可以考虑	可以考虑
米粉	米粉
们会	们会
摄影师	摄影师
庐山	庐山
美美	美美
C、	C、
票了	票了
保安	保安
感慨	感慨
否则	否则
落下	落下
所说	所说
饭店	饭店
打印	打印
生态	生态
浏览	浏览
最讨厌	最讨厌
双鱼	双鱼
说出	说出
乐观	乐观
餐厅	餐厅
今天中午	今天中午
恶的	恶的
辣椒	辣椒
迎来	迎来
将来	将来
US	US
星巴克	星巴克
平安	平安
地人	地人
南瓜	南瓜
享有	享有
逛逛	逛逛
位于	位于
DV	DV
新生	新生
感觉好	感觉好
哼哼	哼哼
果汁	果汁
会为	会为
喝咖啡	喝咖啡
真心的	真心的
月中	月中
极佳	极佳
开展	开展
苏泊尔	苏泊尔
情何以堪	情何以堪
会所	会所
合格	合格
配合	配合
流浪	流浪
出租车	出租车
机型	机型
China	China
木马	木马
pu	pu
输入	输入
好似	好似
平方米	平方米
多项	多项
景区	景区
抱抱	抱抱
飞的	飞的
小学	小学
落地	落地
牛牛	牛牛
母亲	母亲
男的	男的
到此	到此
一家三口	一家三口
小妞	小妞
大白	大白
学的	学的
不腻	不腻
妈们	妈们
传奇	传奇
水晶	水晶
票价	票价
缺点	缺点
睡到	睡到
品味	品味
国庆	国庆
完全没有	完全没有
不用担心	不用担心
努力	努力
涨到	涨到
租车	租车
携手	携手
生活	生活
基本	基本
俺家	俺家
没说	没说
评选	评选
回馈	回馈
rat	rat
组装	组装
手术	手术
最喜欢的	最喜欢的
旅游包机	旅游包机
抢不到	抢不到
１月	１月
Sky	Sky
幽雅静谧	幽雅静谧
赢取	赢取
很顺	很顺
不见不散	不见不散
年轻的	年轻的
清的	清的
小宝	小宝
女士	女士
友人	友人
多个	多个
爱我	爱我
一轮	一轮
结婚	结婚
浴室	浴室
溜溜	溜溜
释放	释放
傻	傻
打车	打车
钻石	钻石
点菜	点菜
限制	限制
想要的	想要的
真不错	真不错
很重	很重
好朋友	好朋友
和服	和服
售后服务	售后服务
一日	一日
十三	十三
预定酒店	预定酒店
日常	日常
亮丽	亮丽
珍珠	珍珠
增加	增加
延误	延误
新品	新品
苏宁	苏宁
金鹰	金鹰
注射	注射
好学	好学
成熟	成熟
海南	海南
适度	适度
真想	真想
喜欢吃	喜欢吃
功课	功课
特地	特地
话题	话题
有才	有才
卖场	卖场
意思	意思
解答	解答
JA	JA
sale	sale
妈妈们	妈妈们
收集	收集
联系电话	联系电话
期望	期望
乘客	乘客
二楼	二楼
明确	明确
春天	春天
南大	南大
激素	激素
很好看	很好看
平常	平常
营商	营商
实实	实实
组织	组织
处处	处处
苗条	苗条
扩展	扩展
咖喱	咖喱
含量	含量
确实好	确实好
不利	不利
讲解	讲解
晓得	晓得
快乐	快乐
亲和	亲和
中央	中央
感受到	感受到
整理	整理
超值	超值
走在	走在
四周	四周
hotel	hotel
冰箱	冰箱
崩溃	崩溃
长途	长途
将开通	将开通
Store	Store
劲爆	劲爆
代言	代言
告知	告知
Wind	Wind
昆明	昆明
联系人	联系人
成长	成长
mand	mand
谢谢亲	谢谢亲
party	party
天真	天真
一月	一月
在路上	在路上
西餐厅	西餐厅
混合	混合
各方	各方
进步	进步
一直以来	一直以来
国电	国电
浓的	浓的
冰激凌	冰激凌
药品	药品
建立	建立
街道	街道
好运	好运
呼吸	呼吸
理解	理解
在线	在线
报告	报告
妹的	妹的
常用	常用
中餐	中餐
窗外	窗外
徒步	徒步
老爷	老爷
首发	首发
同志	同志
文艺	文艺
全身	全身
多重	多重
换购的	换购的
产量	产量
直奔	直奔
不清楚	不清楚
集中	集中
勇敢	勇敢
免税	免税
山东	山东
兼职	兼职
一下午	一下午
良好的	良好的
深深	深深
大米	大米
双手	双手
just	just
大半夜	大半夜
氧化	氧化
大超市	大超市
第二次	第二次
噪音	噪音
body	body
人群	人群
插画	插画
赚钱	赚钱
漂亮	漂亮
必然	必然
竟然	竟然
周年庆	周年庆
TCL	TCL
优秀的	优秀的
试过	试过
牙膏	牙膏
排骨	排骨
安装	安装
一颗	一颗
high	high
抢先	抢先
大餐	大餐
秋冬	秋冬
最好吃的	最好吃的
矿泉水	矿泉水
步行	步行
难受	难受
透气	透气
伙子	伙子
惠价	惠价
晴天	晴天
味道不错	味道不错
质量问题	质量问题
FA	FA
产地	产地
烦恼	烦恼
速度快	速度快
弟弟	弟弟
很精致	很精致
节假	节假
协会	协会
俱全	俱全
不幸	不幸
喜爱	喜爱
细胞	细胞
好想去	好想去
巴厘	巴厘
大厦	大厦
天空	天空
任务	任务
舒服的	舒服的
捡到	捡到
清理	清理
不好意思	不好意思
爆发	爆发
美国的	美国的
随身	随身
公交车	公交车
小米手机	小米手机
航班	航班
外面的	外面的
提升	提升
面临	面临
空姐	空姐
分量	分量
发表了博文	发表了博文
治疗	治疗
相差	相差
溢着	溢着
效率	效率
Love	Love
不好吃	不好吃
大片	大片
偷笑	偷笑
芝士	芝士
营销	营销
恶劣	恶劣
完美	完美
本店	本店
填写	填写
广播	广播
没事	没事
办理	办理
鼓浪屿	鼓浪屿
惊讶	惊讶
尽快	尽快
地道	地道
超赞	超赞
菠萝	菠萝
应用	应用
尽量	尽量
市場	市場
成人	成人
藏匿	藏匿
喜乐	喜乐
两个小时	两个小时
心血	心血
著名的	著名的
苦逼	苦逼
到晚上	到晚上
买家	买家
羽绒	羽绒
想法	想法
奢侈品	奢侈品
第一天	第一天
优酷网	优酷网
早点	早点
人身	人身
工行	工行
逛街	逛街
红色	红色
实惠的	实惠的
兰轩	兰轩
西子湖	西子湖
净化	净化
不明白	不明白
声明	声明
简单	简单
占据	占据
维修	维修
洋葱	洋葱
看过来	看过来
选出	选出
内涵	内涵
中华	中华
比较高	比较高
餐具	餐具
个性	个性
建造	建造
养生	养生
身心	身心
千万不要	千万不要
普遍	普遍
抱怨	抱怨
突然	突然
卖家	卖家
口腔	口腔
来福士	来福士
编辑	编辑
添加	添加
西子	西子
城区	城区
家门	家门
三包	三包
袋子	袋子
校园	校园
饲料	饲料
景色	景色
商家	商家
Tree	Tree
单独	单独
好喜欢	好喜欢
放松	放松
入口	入口
长安	长安
纯天然	纯天然
嘉年华	嘉年华
本地	本地
事实	事实
任何	任何
市场	市场
香格里拉	香格里拉
试试	试试
风光	风光
暖的	暖的
心理	心理
创办	创办
归来	归来
截止	截止
中国第一	中国第一
新手	新手
下单	下单
爱好者	爱好者
适用	适用
统计	统计
年会	年会
半价	半价
吃个	吃个
xp	xp
不便	不便
迅速	迅速
普吉	普吉
导航	导航
各个	各个
更换	更换
登上	登上
一副	一副
高高	高高
乐趣	乐趣
页面	页面
信任	信任
不爱	不爱
降低	降低
渠道	渠道
市民	市民
现金	现金
花香	花香
影像	影像
全没有	全没有
空中	空中
穿着	穿着
心感	心感
推出	推出
恐怖	恐怖
treet	treet
名片	名片
空空	空空
年纪	年纪
Banya	Banya
放弃	放弃
农民	农民
雨天	雨天
无锡	无锡
火热	火热
仅仅是	仅仅是
星星	星星
SD	SD
好幸福	好幸福
陪着	陪着
品种	品种
不愿	不愿
内胆	内胆
mark	mark
未来	未来
玉米	玉米
会员卡	会员卡
销商	销商
两块	两块
使用的	使用的
查到	查到
新店	新店
还不是	还不是
NC	NC
哪样	哪样
最牛	最牛
弱爆	弱爆
颠覆	颠覆
主人	主人
空的	空的
浴缸	浴缸
背包	背包
下一个	下一个
聚会	聚会
媳妇	媳妇
性价	性价
美味	美味
单纯	单纯
沙滩	沙滩
国旅	国旅
抗氧	抗氧
灵感	灵感
买不起	买不起
关心	关心
学习	学习
走进	走进
想问	想问
复杂	复杂
恭喜	恭喜
出來	出來
不接	不接
她们	她们
工艺	工艺
淘宝店	淘宝店
爱好	爱好
福特	福特
安检	安检
微薄	微薄
工作人员	工作人员
年展	年展
三亚	三亚
飞来	飞来
西门	西门
RM	RM
好事	好事
skin	skin
份额	份额
less	less
微波炉	微波炉
独特的	独特的
朋友们	朋友们
有活动	有活动
电源	电源
加钱	加钱
晚报	晚报
大图	大图
烧肉	烧肉
三位	三位
中式	中式
感恩	感恩
在于	在于
ski	ski
跑出	跑出
果真	果真
制服	制服
黄灯	黄灯
声音	声音
疯狂	疯狂
连续	连续
必备	必备
兴趣	兴趣
掌握	掌握
泳池	泳池
精致	精致
三件	三件
满满的	满满的
瑕疵	瑕疵
售票	售票
境内	境内
第三个	第三个
旅行网	旅行网
YP	YP
BC	BC
精选	精选
台北	台北
硬度	硬度
BE	BE
满意的	满意的
CCT	CCT
外卖	外卖
馒头	馒头
随意	随意
玩具	玩具
不必	不必
实好	实好
晒太阳	晒太阳
大连	大连
招商	招商
自助	自助
翠竹	翠竹
方位	方位
不敢	不敢
加拿大	加拿大
倒闭	倒闭
吉隆坡的	吉隆坡的
居民	居民
恶心	恶心
地理	地理
民航	民航
来电	来电
补贴	补贴
深蓝	深蓝
宜人	宜人
饺子	饺子
到过	到过
物流	物流
真实	真实
签证	签证
国外	国外
六个	六个
前去	前去
对面的	对面的
饮食	饮食
可用	可用
here	here
女生	女生
胜利	胜利
从不	从不
平静	平静
不一定	不一定
葫芦	葫芦
非常不错	非常不错
可口	可口
价格是	价格是
罢了	罢了
BA	BA
海口	海口
天蝎	天蝎
挺不错	挺不错
学期	学期
的土	的土
lv	lv
吃着	吃着
洗车	洗车
银联	银联
手套	手套
火车票	火车票
加班	加班
IS	IS
丁丁	丁丁
面条	面条
耽误	耽误
究竟	究竟
看电影	看电影
相当于	相当于
中文名	中文名
老爸	老爸
大巴	大巴
外国	外国
知识	知识
走出	走出
单人	单人
不多	不多
赞成	赞成
估计	估计
投入	投入
book	book
跟随	跟随
有需要的	有需要的
一杯	一杯
场地	场地
浏览器	浏览器
高度	高度
决定	决定
重重	重重
替代	替代
秒杀	秒杀
外出	外出
UE	UE
新年第一	新年第一
一流	一流
一盘	一盘
大促	大促
充足	充足
只需要	只需要
经理	经理
好多了	好多了
买衣服	买衣服
事情	事情
最低	最低
all	all
风景	风景
度假	度假
没啥	没啥
用户	用户
糯米	糯米
新疆	新疆
同款	同款
寒假	寒假
Sam	Sam
卡通	卡通
爱情	爱情
吊丝	吊丝
主页	主页
障碍	障碍
合肥	合肥
sue	sue
一根	一根
开启	开启
现实	现实
互相	互相
很好吃	很好吃
宣布	宣布
融合	融合
过关	过关
忽然	忽然
per	per
新人	新人
用过	用过
大道	大道
临时	临时
覆盖	覆盖
each	each
当中	当中
黄瓜	黄瓜
工作人	工作人
安慰	安慰
地位	地位
记者	记者
产品价格	产品价格
评论	评论
冰激	冰激
私人	私人
俱乐部	俱乐部
到达	到达
抢到	抢到
很舒服	很舒服
差别	差别
总结	总结
厂家	厂家
收银小	收银小
匿于	匿于
不适合	不适合
参考	参考
出现	出现
音讯	音讯
经销商	经销商
LED	LED
本周	本周
迎新	迎新
不愧	不愧
自驾	自驾
最主要	最主要
香港半岛	香港半岛
或许	或许
真正	真正
free	free
惊艳	惊艳
最后	最后
上学	上学
仍然	仍然
改进	改进
家伙	家伙
三月	三月
空间	空间
何以	何以
反而	反而
调整	调整
一点都不	一点都不
再加上	再加上
LZ	LZ
出炉	出炉
居然	居然
诸多	诸多
强力	强力
你妹	你妹
较好	较好
line	line
悲剧	悲剧
红的	红的
不久	不久
休闲	休闲
马币	马币
消费	消费
远离	远离
Win	Win
总的	总的
接到	接到
不能吃	不能吃
mar	mar
来到	来到
神马	神马
年庆	年庆
用到	用到
水器	水器
美人	美人
果然	果然
定做	定做
好难	好难
一次吃	一次吃
无论是	无论是
想好	想好
斯文	斯文
最好吃	最好吃
设施	设施
活在	活在
水饺	水饺
罗斯	罗斯
温馨	温馨
欧美	欧美
吃好	吃好
柔软	柔软
wifi	wifi
宜家	宜家
处于	处于
通话	通话
最强	最强
小牛	小牛
很实	很实
太大了	太大了
部分商品	部分商品
灰常	灰常
听到	听到
利润	利润
海淘	海淘
德国刀具	德国刀具
一直想	一直想
对象	对象
差的	差的
因為	因為
边看	边看
害我	害我
百家	百家
宾馆	宾馆
爹的	爹的
特殊的	特殊的
美食	美食
三八	三八
广西	广西
拼图	拼图
立刻	立刻
VIP	VIP
爱美	爱美
淡定	淡定
太久	太久
十年	十年
着实	着实
sun	sun
森林	森林
德国人	德国人
便捷	便捷
好感	好感
展示	展示
奢华	奢华
优酷	优酷
敏感	敏感
交车	交车
数量有限	数量有限
可悲	可悲
盛大开业	盛大开业
睡前	睡前
给力的	给力的
获取	获取
薯片	薯片
别忘了	别忘了
足够	足够
换成	换成
大酒店	大酒店
成立	成立
性感	性感
走路	走路
期间	期间
福州	福州
旅游攻略	旅游攻略
越南	越南
出名	出名
不安	不安
打电话	打电话
车站	车站
拱墅区	拱墅区
elle	elle
司机	司机
韩国人	韩国人
西餐	西餐
小区	小区
新浪微博	新浪微博
风情	风情
做工	做工
不吃	不吃
聚异麦芽糖	聚异麦芽糖
腊八	腊八
轻松	轻松
买车	买车
口感	口感
市场买	市场买
身边的	身边的
men	men
电影院	电影院
第五	第五
总觉得	总觉得
泊尔	泊尔
地点	地点
踏实	踏实
店内	店内
程序	程序
烤肉	烤肉
lie	lie
干脆	干脆
很精	很精
任意	任意
From	From
小强	小强
没看到	没看到
总觉	总觉
不舒服	不舒服
携带	携带
飞行	飞行
不满	不满
小屋	小屋
不舒	不舒
见证	见证
界面	界面
锋利	锋利
之余	之余
幸运	幸运
某人	某人
年华	年华
分店	分店
取消	取消
想做	想做
主要的	主要的
菜市场的	菜市场的
感兴趣	感兴趣
清洗	清洗
屁股	屁股
邮费	邮费
mily	mily
味儿	味儿
难吃	难吃
清香	清香
享受	享受
策略	策略
不方便	不方便
前后	前后
居住	居住
大堂	大堂
很清	很清
对着	对着
黑色	黑色
黄色	黄色
温暖的	温暖的
卖出	卖出
柜台	柜台
有意思	有意思
形式	形式
湖州	湖州
丢了	丢了
很大的	很大的
展现	展现
英语	英语
综合	综合
印花	印花
广场店	广场店
小哥	小哥
世界上	世界上
古老的	古老的
arc	arc
New	New
最好	最好
千里	千里
选择	选择
微博配图	微博配图
警察	警察
换个	换个
Mr	Mr
二十	二十
移动	移动
跑去	跑去
马路	马路
不妨	不妨
現在	現在
车上	车上
道路	道路
亮的	亮的
睡袋	睡袋
UM	UM
安排	安排
清新	清新
接近	接近
滋味	滋味
就是我	就是我
搭配	搭配
按照	按照
给他们	给他们
公馆	公馆
几个月	几个月
多少钱	多少钱
涂层	涂层
本月	本月
糟糕	糟糕
邮箱	邮箱
例如	例如
买衣	买衣
关于	关于
验证	验证
一组	一组
童鞋	童鞋
太给力	太给力
更是	更是
西瓜	西瓜
故障	故障
配上	配上
梦幻	梦幻
针对	针对
没有任何	没有任何
全新的	全新的
无疑	无疑
长城脚下	长城脚下
出品	出品
心中	心中
虽然没	虽然没
资本	资本
用电	用电
没见	没见
木瓜	木瓜
过去的	过去的
小孩	小孩
最美	最美
芒果	芒果
购票	购票
表现	表现
道具	道具
拉萨	拉萨
千万不	千万不
尽管	尽管
转变	转变
出发	出发
热销	热销
退换	退换
人均	人均
等地	等地
囡囡	囡囡
涨价	涨价
男女	男女
出差	出差
老年	老年
原因	原因
米饭	米饭
剩下	剩下
青花	青花
leep	leep
面包	面包
果壳网	果壳网
抗生素饲料	抗生素饲料
长城	长城
道理	道理
美容	美容
哈尔滨	哈尔滨
六点	六点
修好	修好
也许	也许
新城	新城
差点	差点
庆幸	庆幸
六神	六神
鼓掌	鼓掌
产生	产生
FD	FD
银隆	银隆
形成	形成
纷纷	纷纷
高品质	高品质
习惯	习惯
树叶	树叶
四大	四大
一万	一万
场卖	场卖
麦芽	麦芽
总产量	总产量
照片	照片
印加	印加
竟是	竟是
物质	物质
room	room
与其	与其
致电	致电
铁道部	铁道部
年底	年底
大马	大马
荣获	荣获
公交	公交
动态	动态
影响	影响
DM	DM
偶然	偶然
哈尔	哈尔
理念	理念
推出的	推出的
领取	领取
正大	正大
充电	充电
大卖	大卖
抢购	抢购
丰富的	丰富的
专业的	专业的
全程	全程
但愿	但愿
甜品	甜品
相机	相机
豆浆	豆浆
造型	造型
再来	再来
路到	路到
新的一年	新的一年
收拾	收拾
新建	新建
late	late
最差	最差
不可以	不可以
一会儿	一会儿
从此	从此
把手	把手
店员	店员
大酒	大酒
员工	员工
致力	致力
好不容易	好不容易
配备	配备
干净	干净
超市的	超市的
家工	家工
浩特	浩特
产业	产业
豪华的	豪华的
西湖	西湖
研发	研发
多买	多买
不贵	不贵
遇到	遇到
双人	双人
来这里	来这里
太多	太多
创造	创造
酒店设计	酒店设计
糊涂	糊涂
美女	美女
几年前	几年前
费用	费用
轿车	轿车
来自专辑	来自专辑
都用	都用
出口	出口
SOHO	SOHO
今天下午	今天下午
南白	南白
厨房	厨房
能不能	能不能
祝福	祝福
叔叔	叔叔
杭州	杭州
在外	在外
手续	手续
low	low
水	水
流程	流程
保存	保存
可谓	可谓
明年	明年
应该是	应该是
会不会	会不会
千元	千元
丽江	丽江
搞活动	搞活动
绝对	绝对
rap	rap
过程	过程
一号	一号
吉祥	吉祥
可怕	可怕
总体	总体
冰	冰
light	light
何时	何时
寒风	寒风
早起	早起
所在	所在
优化	优化
奔驰	奔驰
污染	污染
有用	有用
怀疑	怀疑
能够	能够
他妈的	他妈的
力推	力推
正宗	正宗
一袋	一袋
一顿	一顿
男朋友	男朋友
三个人	三个人
杭州西溪	杭州西溪
溪悦榕庄	溪悦榕庄
分布	分布
减少	减少
半岛酒店	半岛酒店
老太	老太
巴黎	巴黎
每年	每年
极品	极品
西亚	西亚
少有	少有
ama	ama
德清	德清
抗议	抗议
提交	提交
大家看	大家看
紧张	紧张
呼和浩特	呼和浩特
气愤	气愤
专家	专家
无人	无人
远远	远远
这么多	这么多
云南白药	云南白药
好意思	好意思
愤怒	愤怒
吃喝	吃喝
下图	下图
相当	相当
内人	内人
运气	运气
总部	总部
Green	Green
用来	用来
arch	arch
同城	同城
设置	设置
订了	订了
House	House
折后	折后
不就是	不就是
西湖四季	西湖四季
美好	美好
新出	新出
贴心	贴心
拆开	拆开
国际	国际
广告	广告
素质	素质
满足	满足
江湖	江湖
陕西	陕西
规定	规定
几分	几分
参观	参观
订购	订购
羽毛	羽毛
麦芽糖产能	麦芽糖产能
女白领	女白领
私家	私家
女性	女性
此外	此外
亚航	亚航
动车	动车
一般	一般
工资	工资
好不好	好不好
湖区	湖区
条件	条件
出售	出售
开到	开到
一面	一面
实体店	实体店
刚开始	刚开始
拿出	拿出
到时	到时
集锦	集锦
合作伙伴	合作伙伴
金山	金山
发货	发货
促销员	促销员
拱墅	拱墅
很给力	很给力
拒绝	拒绝
市中心	市中心
稍微	稍微
两个月	两个月
机械	机械
有一天	有一天
气温	气温
树	树
在家里	在家里
太好了	太好了
前台	前台
功能	功能
买菜的	买菜的
我妈	我妈
里拉	里拉
链接	链接
面前	面前
热的	热的
送到	送到
量大	量大
挺好	挺好
想说	想说
thing	thing
包含	包含
幽雅	幽雅
动手	动手
文章	文章
姐姐	姐姐
关键是	关键是
天发	天发
优秀	优秀
浓墨	浓墨
度假酒店	度假酒店
分一杯羹	分一杯羹
瑞吉	瑞吉
公社	公社
大自然	大自然
重庆	重庆
春节	春节
round	round
精品酒店	精品酒店
柏联	柏联
阿迪	阿迪
重要的是	重要的是
平方	平方
可爱的	可爱的
限时	限时
成就	成就
厚的	厚的
比较脆	比较脆
安徽	安徽
鉴定	鉴定
强大的	强大的
环球	环球
承诺	承诺
所谓的	所谓的
坑爹的	坑爹的
观影	观影
一层	一层
浦东	浦东
整整	整整
有意者	有意者
比起来	比起来
收起	收起
这么好	这么好
大号	大号
远了	远了
说法	说法
没去	没去
浙江	浙江
买不到	买不到
认真	认真
特价	特价
确保	确保
充分	充分
乐购超市	乐购超市
想象	想象
充满	充满
会议	会议
一扫	一扫
大妈	大妈
自身	自身
用刀	用刀
中分	中分
阿里	阿里
四年	四年
工厂	工厂
问下	问下
lab	lab
今早	今早
湖北	湖北
菜市场买菜	菜市场买菜
定时	定时
沟通	沟通
定制	定制
理由	理由
集齐	集齐
购集印花	购集印花
三墩路	三墩路
嘤嘤	嘤嘤
换购	换购
like	like
喜欢刀具	喜欢刀具
乐购集印花	乐购集印花
双立人	双立人
因为没电	因为没电
换刀具活动	换刀具活动
有两个下场	有两个下场
设计集锦	设计集锦
建筑设计	建筑设计
德国双立人	德国双立人
双立人刀具	双立人刀具
酒店集锦	酒店集锦
刀具的刀友	刀具的刀友
却买不	却买不
刀友	刀友
顶级酒店	顶级酒店
喜欢刀	喜欢刀
印花换刀	印花换刀
乐购集印	乐购集印
德国品牌	德国品牌
友请关注	友请关注
名刀	名刀
免费机票	免费机票
复出	复出
名刀专辑	名刀专辑
丽江悦榕庄	丽江悦榕庄
法云酒店	法云酒店
人生观	人生观
能买来	能买来
away	away
胖子叫苗条	胖子叫苗条
乐购的印花	乐购的印花
莫干山	莫干山
万张免费	万张免费
硬质合金	硬质合金
灵隐寺	灵隐寺
印花换刀具	印花换刀具
印花一枚	印花一枚
炉包	炉包
杭州法云	杭州法云
超级锋利性	超级锋利性
安缦法云	安缦法云
一般的雕工	一般的雕工
锋利性	锋利性
超级锋利	超级锋利
逛不完	逛不完
大乐购	大乐购
地摊	地摊
为了回馈	为了回馈
显示他们	显示他们
全长	全长
刃厚	刃厚
龙江店	龙江店
旅客	旅客
广大旅客	广大旅客
神一般的	神一般的
平面广告	平面广告
送印花	送印花
好心人	好心人
单笔	单笔
建筑	建筑
旅客对亚航	旅客对亚航
西溪悅榕莊	西溪悅榕莊
购物券	购物券
亚航的支持	亚航的支持
一起去菜市	一起去菜市
穿不完的	穿不完的
奢华酒	奢华酒
德国克虏伯	德国克虏伯
克虏伯公司	克虏伯公司
溪悅榕莊	溪悅榕莊
卜蜂莲花	卜蜂莲花
水果刀	水果刀
模板	模板
新春乐购	新春乐购
Eve	Eve
李阿姨	李阿姨
创意园	创意园
木工	木工
贵宾	贵宾
ej	ej
ssic	ssic
gure	gure
永乐	永乐
fk	fk
兑换	兑换
法云古镇	法云古镇
凤凰涅磐	凤凰涅磐
大使	大使
power	power
行内人士	行内人士
大伯	大伯
涅磐	涅磐
凤凰	凤凰
肇事	肇事
建筑学	建筑学
订票	订票
ours	ours
漳州万达	漳州万达
狮子座	狮子座
换刀具	换刀具
缦法云	缦法云
anfa	anfa
旧的	旧的
围脖	围脖
rtu	rtu
mpa	mpa
OI	OI
强壮	强壮
书记	书记
aya	aya
伊朗	伊朗
永福	永福
mit	mit
市场调查	市场调查
购物卡	购物卡
发起人	发起人
参加抽奖	参加抽奖
新锐	新锐
tay	tay
铜陵	铜陵
陌生人	陌生人
eq	eq
苍井空	苍井空
sing	sing
恢复	恢复
isco	isco
刀子	刀子
洗衣机	洗衣机
招牌	招牌
送货	送货
主妇	主妇
乐扣	乐扣
一枚	一枚
园区	园区
度过	度过
回忆	回忆
较高	较高
白了	白了
MP	MP
gy	gy
液晶	液晶
net	net
核桃	核桃
卖了	卖了
母婴	母婴
ting	ting
仅需	仅需
let	let
酸奶	酸奶
胃口	胃口
蚊子	蚊子
ere	ere
路过	路过
当当	当当
汕头	汕头
杰出	杰出
以免	以免
工作日	工作日
破产	破产
每周	每周
萌系	萌系
ilo	ilo
rank	rank
猝死	猝死
开朗	开朗
纽约	纽约
GT	GT
套餐	套餐
jS	jS
东南	东南
无所谓	无所谓
胖子	胖子
安全感	安全感
uz	uz
更加	更加
IC	IC
图钉	图钉
名品	名品
ivat	ivat
Hello	Hello
锅底	锅底
改造	改造
街上	街上
村落	村落
双立人锅具	双立人锅具
tf	tf
包机	包机
check	check
考验	考验
very	very
Sc	Sc
Jack	Jack
粉色	粉色
郁闷	郁闷
旋转	旋转
姐夫	姐夫
被迫	被迫
异常	异常
现价	现价
夸张	夸张
原装	原装
当代	当代
三鹿	三鹿
快速	快速
get	get
mis	mis
way	way
LA	LA
客车	客车
高峰	高峰
白领	白领
xc	xc
销量	销量
古村	古村
every	every
gl	gl
满身	满身
发呆	发呆
even	even
ear	ear
箱子	箱子
频道	频道
生日快乐	生日快乐
年初	年初
番禺	番禺
现象	现象
爷爷	爷爷
德清县	德清县
茶园	茶园
受欢迎	受欢迎
钓鱼	钓鱼
老鼠	老鼠
三个月	三个月
出色	出色
最佳精品	最佳精品
艺术作品	艺术作品
店铺	店铺
申请	申请
设备	设备
正直	正直
帅哥	帅哥
建筑艺术	建筑艺术
收藏	收藏
华尔道夫	华尔道夫
顶级	顶级
柏悦酒店	柏悦酒店
御庭精品	御庭精品
北京柏悦	北京柏悦
发挥	发挥
上海外滩	上海外滩
上海东方	上海东方
瑜舍酒店	瑜舍酒店
南京秦淮河	南京秦淮河
断奶	断奶
裤子	裤子
有味	有味
低价	低价
木材	木材
花园	花园
娱乐	娱乐
Weico	Weico
riva	riva
元旦	元旦
老外	老外
品酒	品酒
讨论	讨论
凌晨	凌晨
新华	新华
懒得	懒得
适合	适合
精心	精心
著名	著名
美丽	美丽
牛逼	牛逼
一夜	一夜
资讯	资讯
好好学习	好好学习
杰出建筑师	杰出建筑师
信号	信号
莲花	莲花
店主	店主
服务员	服务员
举行	举行
Me	Me
Aman	Aman
婆婆	婆婆
宁静	宁静
贴膜	贴膜
亲们	亲们
双年展	双年展
结合	结合
广东	广东
人品	人品
诚信	诚信
五点	五点
Ash	Ash
抽奖	抽奖
威尼斯	威尼斯
当代建筑艺	当代建筑艺
代建筑艺术	代建筑艺术
参展	参展
CT	CT
狮子	狮子
end	end
MS	MS
可可	可可
冠军	冠军
分类	分类
半个月	半个月
奶奶	奶奶
MB	MB
实现	实现
心疼	心疼
交易	交易
via	via
蛮好	蛮好
欧尚超市	欧尚超市
高档	高档
共享	共享
政府	政府
运营	运营
天津	天津
支付宝	支付宝
天虹	天虹
ten	ten
商务	商务
锅子	锅子
厕所	厕所
潘石屹	潘石屹
周二	周二
val	val
上门	上门
配图	配图
中山	中山
第一次去	第一次去
CD	CD
十二	十二
开幕	开幕
账单	账单
出游	出游
折腾	折腾
周五	周五
pro	pro
oot	oot
注重	注重
ust	ust
西溪悦榕庄	西溪悦榕庄
御庭	御庭
别墅	别墅
周六	周六
号称	号称
明星	明星
有限	有限
容量	容量
讨厌	讨厌
抵达	抵达
TT	TT
通用	通用
代表	代表
甜甜	甜甜
aba	aba
ifi	ifi
sho	sho
最受欢迎	最受欢迎
音响	音响
大多数	大多数
英国	英国
pass	pass
好评	好评
hell	hell
FO	FO
石头	石头
饼干	饼干
图书	图书
ank	ank
热门	热门
最多	最多
难过	难过
提前	提前
中文	中文
浪漫	浪漫
四川	四川
KO	KO
ff	ff
CK	CK
欧洲	欧洲
刺激	刺激
AD	AD
袜子	袜子
清晰	清晰
FE	FE
电器	电器
much	much
挑战	挑战
天猫	天猫
MC	MC
午餐	午餐
杭州西溪悦	杭州西溪悦
丸子	丸子
车票	车票
iva	iva
tern	tern
涂鸦	涂鸦
视界	视界
现金券	现金券
娃娃	娃娃
NY	NY
电视机	电视机
百姓	百姓
气氛	气氛
启动	启动
乐活	乐活
only	only
正确	正确
转发微博	转发微博
收费	收费
超级好	超级好
照明	照明
飞利浦	飞利浦
ami	ami
互动	互动
炒饭	炒饭
实用	实用
旗下	旗下
全家	全家
再也不	再也不
装修	装修
bee	bee
定期	定期
核心	核心
媒体	媒体
妇女	妇女
老人	老人
直播	直播
真心不错	真心不错
仿佛	仿佛
how	how
接待	接待
百年	百年
愉快	愉快
公开	公开
支付	支付
反复	反复
公里	公里
钢琴	钢琴
没来	没来
日报	日报
放假	放假
失败	失败
中午	中午
举办	举办
以前	以前
职业	职业
eap	eap
专题	专题
网页	网页
航官	航官
领先	领先
荷兰	荷兰
特点	特点
AA	AA
东北	东北
当日	当日
新天地	新天地
ath	ath
详细	详细
卡片	卡片
牛仔	牛仔
一次性	一次性
姐妹们	姐妹们
途中	途中
设计师	设计师
剃须刀	剃须刀
仅限	仅限
很赞	很赞
抓紧	抓紧
吐槽	吐槽
长沙	长沙
牛奶	牛奶
物品	物品
回国	回国
情人节	情人节
苏州	苏州
可怜	可怜
世纪	世纪
神秘	神秘
室内	室内
插件	插件
美图	美图
番茄	番茄
sl	sl
Ro	Ro
石家庄	石家庄
首次	首次
老婆	老婆
老娘	老娘
气死	气死
引发	引发
十足	十足
正品	正品
意外	意外
画廊	画廊
三十	三十
白色	白色
IF	IF
仔细	仔细
自家	自家
同行	同行
看不到	看不到
AM	AM
原价	原价
良心	良心
阿姨	阿姨
怀念	怀念
照顾	照顾
小孩子	小孩子
新浪	新浪
It	It
西北	西北
文件	文件
El	El
oli	oli
关闭	关闭
retre	retre
不对	不对
福利	福利
地址	地址
拍摄	拍摄
ada	ada
点心	点心
动物	动物
买菜	买菜
洗发水	洗发水
漳州	漳州
询问	询问
南宁	南宁
礼品	礼品
假酒	假酒
每晚	每晚
esco	esco
有点小	有点小
独立	独立
人人	人人
有名	有名
停车	停车
私信	私信
营业	营业
有感而发	有感而发
服务费	服务费
大一	大一
业务	业务
压力	压力
加大	加大
esc	esc
阳台	阳台
专卖店	专卖店
纯正	纯正
温泉	温泉
举报	举报
想念	想念
周四	周四
NG	NG
好人	好人
sch	sch
昨日	昨日
上市	上市
ix	ix
信用	信用
市区	市区
电饭煲	电饭煲
南区	南区
晚安	晚安
央视	央视
十一	十一
危险	危险
生意	生意
热闹	热闹
your	your
医生	医生
treat	treat
你们	你们
查询	查询
三百	三百
安心	安心
数字	数字
ost	ost
关键	关键
实体	实体
小吃	小吃
伙伴	伙伴
周日	周日
hat	hat
黄金	黄金
规格	规格
网购	网购
服装	服装
每日	每日
地铁	地铁
适应	适应
特意	特意
两个	两个
特惠	特惠
提前一天	提前一天
图书馆	图书馆
手工	手工
ons	ons
备用	备用
nake	nake
多款	多款
之内	之内
with	with
甜的	甜的
空调	空调
bala	bala
gs	gs
生了	生了
适中	适中
茶馆	茶馆
合金	合金
离子	离子
烧烤	烧烤
破了	破了
省钱	省钱
涨了	涨了
一个星期	一个星期
ET	ET
枕头	枕头
地摊货	地摊货
菜刀	菜刀
月底	月底
退票	退票
LG	LG
精美	精美
che	che
wit	wit
宿舍	宿舍
MI	MI
nts	nts
高兴	高兴
太坑	太坑
妈妈	妈妈
留言	留言
Quech	Quech
下雨	下雨
her	her
tea	tea
Mu	Mu
国有	国有
屌丝	屌丝
ime	ime
xt	xt
主动	主动
Jac	Jac
有多少	有多少
欣赏	欣赏
亲切	亲切
符合	符合
假日	假日
这两天	这两天
假的	假的
BT	BT
神经	神经
人性化	人性化
eats	eats
大街	大街
办公	办公
优质	优质
ouse	ouse
描述	描述
awa	awa
玩转	玩转
抢票	抢票
ill	ill
sto	sto
转载	转载
扬州	扬州
佛山	佛山
赞的	赞的
KA	KA
ees	ees
uti	uti
领域	领域
座位	座位
ture	ture
din	din
nic	nic
互联网	互联网
sco	sco
cho	cho
毫无	毫无
下午茶	下午茶
dro	dro
rom	rom
信心	信心
事故	事故
情人	情人
echua	echua
ssi	ssi
儿童	儿童
NO	NO
号码	号码
结账	结账
不锈钢	不锈钢
越野	越野
淮河	淮河
廉价	廉价
jd	jd
伤不起	伤不起
ding	ding
ls	ls
唯一	唯一
身份	身份
sj	sj
收银员	收银员
tai	tai
ick	ick
迷你	迷你
火爆	火爆
大学	大学
包裹	包裹
厨具	厨具
AC	AC
gre	gre
提示	提示
人气	人气
零食	零食
肚子	肚子
old	old
全面	全面
墨尔本	墨尔本
回答	回答
瞬间	瞬间
高级	高级
沈阳	沈阳
hua	hua
华尔	华尔
身高	身高
多种	多种
水平	水平
坏了	坏了
偶尔	偶尔
交通	交通
ian	ian
坑爹	坑爹
大陆	大陆
静谧	静谧
一塌糊涂	一塌糊涂
口味	口味
售价	售价
果子	果子
推车	推车
官方	官方
班车	班车
配件	配件
多次	多次
小聚	小聚
实话	实话
mor	mor
普通	普通
der	der
东方	东方
下班	下班
十五	十五
强烈推荐	强烈推荐
und	und
豪礼	豪礼
over	over
ack	ack
大奖	大奖
办公室	办公室
操作	操作
保障	保障
son	son
随时	随时
负责	负责
旗舰	旗舰
两件	两件
CL	CL
升级	升级
折扣	折扣
man	man
nly	nly
独家	独家
our	our
案例	案例
开车	开车
sm	sm
Fi	Fi
工业	工业
温柔	温柔
邀请	邀请
批发	批发
pla	pla
半个	半个
付款	付款
团队	团队
感谢	感谢
蘑菇	蘑菇
离开	离开
套装	套装
错了	错了
成本	成本
专卖	专卖
蛋糕	蛋糕
连锁	连锁
当地	当地
时光	时光
似乎	似乎
河南	河南
年轻	年轻
参与	参与
午饭	午饭
厉害	厉害
表面	表面
万达	万达
天使	天使
首先	首先
根本不	根本不
利用	利用
洗衣	洗衣
坚决	坚决
塑料	塑料
五星级	五星级
不如	不如
提高	提高
范围	范围
以下	以下
下载	下载
ES	ES
实际	实际
温度	温度
WI	WI
早餐	早餐
彻底	彻底
当天	当天
节日	节日
一斤	一斤
和平	和平
香的	香的
jk	jk
vo	vo
ass	ass
交流	交流
秦淮	秦淮
客人	客人
眼镜	眼镜
妹子	妹子
dis	dis
日本	日本
avi	avi
麻辣	麻辣
型号	型号
失望	失望
官网	官网
NA	NA
age	age
位置	位置
eat	eat
登陆	登陆
op	op
缤纷	缤纷
小伙	小伙
tri	tri
gr	gr
入手	入手
百货	百货
ik	ik
爱吃	爱吃
确认	确认
ose	ose
两次	两次
一名	一名
元以上	元以上
SO	SO
再次	再次
美国	美国
更多的	更多的
资源	资源
奢侈	奢侈
帐篷	帐篷
打算	打算
长的	长的
程度	程度
确实不	确实不
承认	承认
af	af
收银	收银
ste	ste
武汉	武汉
我爱	我爱
巨大	巨大
土豆	土豆
南京	南京
CA	CA
历史	历史
第二天	第二天
ola	ola
nte	nte
ew	ew
热水	热水
一片	一片
无敌	无敌
ts	ts
一圈	一圈
有机	有机
rea	rea
全新	全新
推广	推广
分享图片	分享图片
rr	rr
ed	ed
az	az
促销	促销
长期	长期
ont	ont
加工	加工
当年	当年
ico	ico
广场	广场
本不	本不
哥哥	哥哥
保持	保持
合理	合理
超好	超好
始终	始终
ve	ve
lle	lle
很好	很好
制造	制造
sta	sta
tar	tar
快的	快的
纪念	纪念
ton	ton
Sh	Sh
公布	公布
好心	好心
nl	nl
不同的	不同的
永远	永远
季节	季节
说明	说明
办法	办法
ab	ab
thin	thin
重要的	重要的
我喜欢	我喜欢
前两天	前两天
大量	大量
五星	五星
半岛	半岛
兄弟	兄弟
ty	ty
聊天	聊天
排名	排名
rc	rc
ui	ui
les	les
麻烦	麻烦
研究	研究
ent	ent
lt	lt
ow	ow
记录	记录
QQ	QQ
买到	买到
ara	ara
错的	错的
一般的	一般的
跑了	跑了
检查	检查
留下	留下
ever	ever
太大	太大
不努力	不努力
发表	发表
类似	类似
深圳	深圳
小票	小票
介绍	介绍
商店	商店
起床	起床
ica	ica
当初	当初
及时	及时
心里	心里
点击	点击
一分	一分
只好	只好
相比	相比
最重要	最重要
摄影	摄影
两年	两年
晚饭	晚饭
各地	各地
受不了	受不了
重新	重新
平时	平时
报道	报道
加入	加入
确定	确定
都想	都想
好看	好看
分别	分别
云南	云南
遗憾	遗憾
单位	单位
所以我	所以我
完成	完成
都没有	都没有
为主	为主
正好	正好
很少	很少
考虑	考虑
短信	短信
都是	都是
半年	半年
又不	又不
新鲜	新鲜
给力	给力
丰富	丰富
第四	第四
知名	知名
联网	联网
价位	价位
最新	最新
商旅	商旅
本人	本人
还能	还能
随便	随便
价值	价值
这边	这边
国产	国产
距离	距离
供应	供应
死了	死了
我自己	我自己
带上	带上
需要的	需要的
好想	好想
找不到	找不到
中间	中间
难道	难道
不行	不行
就想	就想
小时	小时
持续	持续
早就	早就
可以去	可以去
经典	经典
反应	反应
不断	不断
积分	积分
ice	ice
一个月	一个月
海报	海报
极其	极其
都很好	都很好
我来	我来
去看看	去看看
没用	没用
can	can
比如	比如
特别是	特别是
看到了	看到了
蔬菜	蔬菜
好久没	好久没
买了	买了
在广州	在广州
一致	一致
假期	假期
就在	就在
精品	精品
大型	大型
口水	口水
快点	快点
一堆	一堆
坐在	坐在
最大的	最大的
打造	打造
use	use
一下	一下
拿了	拿了
全部	全部
顺便	顺便
他的	他的
经济	经济
印度	印度
还不错	还不错
没有	没有
豪华	豪华
不高	不高
豆腐	豆腐
前天	前天
带来	带来
还要	还要
高端	高端
百分之百	百分之百
倍加	倍加
备至	备至
不得了	不得了
不堪	不堪
不可开交	不可开交
不亦乐乎	不亦乐乎
不折不扣	不折不扣
彻头彻尾	彻头彻尾
到头	到头
地地道道	地地道道
极	极
极端	极端
极为	极为
截然	截然
尽	尽
惊人地	惊人地
绝	绝
绝顶	绝顶
绝对化	绝对化
刻骨	刻骨
酷	酷
满贯	满贯
满心	满心
莫大	莫大
奇	奇
入骨	入骨
甚为	甚为
十二分	十二分
十分	十分
死	死
滔天	滔天
痛	痛
透	透
完全	完全
完完全全	完完全全
万	万
万般	万般
万万	万万
无比	无比
无度	无度
无可估量	无可估量
无以复加	无以复加
无以伦比	无以伦比
要死	要死
已极	已极
已甚	已甚
逾常	逾常
贼	贼
之极	之极
之至	之至
至极	至极
卓绝	卓绝
最为	最为
佼佼	佼佼
郅	郅
綦	綦
齁	齁
最	最
不过	不过
不少	不少
不胜	不胜
惨	惨
沉	沉
沉沉	沉沉
出奇	出奇
大为	大为
多	多
多多	多多
多加	多加
分外	分外
格外	格外
够瞧的	够瞧的
够戗	够戗
好	好
好不	好不
何等	何等
很	很
很是	很是
坏	坏
可	可
老	老
良	良
颇	颇
颇为	颇为
甚	甚
实在	实在
太	太
太甚	太甚
特	特
尤	尤
尤其	尤其
尤为	尤为
尤以	尤以
远	远
曷	曷
碜	碜
大不了	大不了
更	更
更进一步	更进一步
更为	更为
还	还
较	较
较比	较比
较为	较为
进一步	进一步
那般	那般
那么	那么
那样	那样
强	强
如斯	如斯
益	益
益发	益发
尤甚	尤甚
逾	逾
愈	愈
愈发	愈发
愈加	愈加
愈来愈	愈来愈
愈益	愈益
越发	越发
越加	越加
越来越	越来越
越是	越是
这般	这般
这样	这样
足	足
足足	足足
点点滴滴	点点滴滴
多多少少	多多少少
怪	怪
好生	好生
或多或少	或多或少
略	略
略加	略加
略略	略略
略微	略微
略为	略为
蛮	蛮
稍	稍
稍稍	稍稍
稍为	稍为
稍许	稍许
挺	挺
未免	未免
些	些
些微	些微
些小	些小
一点	一点
一些	一些
有点	有点
有些	有些
半点	半点
不大	不大
不丁点儿	不丁点儿
不甚	不甚
不怎么	不怎么
聊	聊
没怎么	没怎么
轻度	轻度
弱	弱
丝毫	丝毫
微	微
相对	相对
不为过	不为过
超	超
超额	超额
超外差	超外差
超微结构	超微结构
超物质	超物质
浮	浮
过	过
过度	过度
过分	过分
过火	过火
过劲	过劲
过了头	过了头
过猛	过猛
过热	过热
过甚	过甚
过头	过头
过逾	过逾
何止	何止
何啻	何啻
开外	开外
苦	苦
偏	偏
溢	溢
忒	忒
僄	僄
啰啰唆唆	啰啰唆唆
啰啰嗦嗦	啰啰嗦嗦
啰里啰唆	啰里啰唆
啰里啰嗦	啰里啰嗦
啰唆	啰唆
啰嗦	啰嗦
噲	噲
奓着头发	奓着头发
婞	婞
婞直	婞直
崒	崒
弇陋	弇陋
惛	惛
惼	惼
梼昧	梼昧
獪	獪
瘆	瘆
瘆得慌	瘆得慌
哀鸿遍野	哀鸿遍野
矮	矮
碍难	碍难
碍眼	碍眼
爱搭不理	爱搭不理
爱理不理	爱理不理
暗	暗
暗暗	暗暗
暗沉沉	暗沉沉
暗淡	暗淡
暗地	暗地
暗地里	暗地里
暗黑	暗黑
暗里	暗里
暗昧	暗昧
暗弱	暗弱
暗无天日	暗无天日
暗下	暗下
暗中	暗中
暗自	暗自
暗朦	暗朦
岸然	岸然
肮里肮脏	肮里肮脏
肮脏	肮脏
昂贵	昂贵
凹凸	凹凸
凹凸不平	凹凸不平
傲	傲
傲岸	傲岸
傲慢	傲慢
八面玲珑	八面玲珑
跋扈	跋扈
霸道	霸道
白白	白白
白痴般	白痴般
白搭	白搭
白忙	白忙
白忙活儿	白忙活儿
白衣苍狗	白衣苍狗
白云苍狗	白云苍狗
百孔千疮	百孔千疮
败坏	败坏
稗	稗
板	板
板板六十四	板板六十四
板滞	板滞
半半拉拉	半半拉拉
半路出家	半路出家
半新不旧	半新不旧
半真半假	半真半假
薄	薄
薄情	薄情
薄弱	薄弱
薄幸	薄幸
保残守缺	保残守缺
保守	保守
抱残守缺	抱残守缺
暴	暴
暴烈	暴烈
暴虐	暴虐
暴躁	暴躁
暴戾	暴戾
暴戾恣睢	暴戾恣睢
爆炸性	爆炸性
悲惨	悲惨
悲观	悲观
悲观地	悲观地
悲凉	悲凉
卑	卑
卑鄙	卑鄙
卑鄙无耻	卑鄙无耻
卑贱	卑贱
卑劣	卑劣
卑陋	卑陋
卑怯	卑怯
卑俗	卑俗
卑琐	卑琐
卑微	卑微
卑污	卑污
卑下	卑下
卑猥	卑猥
背地	背地
背地里	背地里
背光	背光
背悔	背悔
背静	背静
背靠背	背靠背
背理	背理
背令	背令
背人	背人
背时	背时
背阴	背阴
被动	被动
被动式	被动式
被动性	被动性
本本主义	本本主义
笨	笨
笨手笨脚	笨手笨脚
笨头笨脑	笨头笨脑
笨重	笨重
笨拙	笨拙
比肩接踵	比肩接踵
鄙	鄙
鄙贱	鄙贱
鄙吝	鄙吝
鄙陋	鄙陋
鄙俗	鄙俗
鄙俚	鄙俚
蔽塞	蔽塞
闭塞	闭塞
必修	必修
变化不定	变化不定
变化多端	变化多端
变化万千	变化万千
变化无常	变化无常
变化无穷	变化无穷
变幻不定	变幻不定
变幻莫测	变幻莫测
变幻无常	变幻无常
变相	变相
表里不一	表里不一
憋拗	憋拗
别别扭扭	别别扭扭
别扭	别扭
别有用心	别有用心
冰冷	冰冷
冰炭不相容	冰炭不相容
秉性剌戾	秉性剌戾
病病歪歪	病病歪歪
病弱	病弱
病态	病态
病歪歪	病歪歪
病殃殃	病殃殃
病恹恹	病恹恹
波谲云诡	波谲云诡
驳杂	驳杂
捕风捉影	捕风捉影
不爱交际	不爱交际
不辨菽麦	不辨菽麦
不才	不才
不成材	不成材
不成功	不成功
不成话	不成话
不成器	不成器
不成熟	不成熟
不成体统	不成体统
不成样子	不成样子
不打紧	不打紧
不大重要	不大重要
不当	不当
不到黄河心不死	不到黄河心不死
不道德	不道德
不得当	不得当
不得劲	不得劲
不得体	不得体
不登大雅之堂	不登大雅之堂
不等	不等
不端	不端
不对茬儿	不对茬儿
不对称	不对称
不对付	不对付
不对劲	不对劲
不对头	不对头
不发达	不发达
不法	不法
不分青红皂白	不分青红皂白
不分皂白	不分皂白
不负责任	不负责任
不干不净	不干不净
不更事	不更事
不公	不公
不公正	不公正
不共戴天	不共戴天
不够格	不够格
不够完善	不够完善
不够意思	不够意思
不关痛痒	不关痛痒
不管三七二十一	不管三七二十一
不管用	不管用
不光彩	不光彩
不光明	不光明
不规则	不规则
不轨	不轨
不好看	不好看
不好客	不好客
不好卖	不好卖
不好使	不好使
不好听	不好听
不好用	不好用
不和	不和
不和蔼	不和蔼
不和谐	不和谐
不合法	不合法
不合理	不合理
不合逻辑	不合逻辑
不合情理	不合情理
不合时令	不合时令
不合时宜	不合时宜
不合适	不合适
不合算	不合算
不合宜	不合宜
不合语法	不合语法
不划算	不划算
不济	不济
不济事	不济事
不俭省	不俭省
不健康	不健康
不洁	不洁
不谨慎	不谨慎
不近情理	不近情理
不近人情	不近人情
不尽	不尽
不尽如人意	不尽如人意
不精确	不精确
不敬	不敬
不绝如缕	不绝如缕
不均匀	不均匀
不开化	不开化
不堪入耳	不堪入耳
不堪入目	不堪入目
不堪设想	不堪设想
不堪一击	不堪一击
不堪造就	不堪造就
不科学	不科学
不可爱	不可爱
不可补救	不可补救
不可读	不可读
不可告人	不可告人
不可更新	不可更新
不可恢复	不可恢复
不可降解	不可降解
不可接受	不可接受
不可救药	不可救药
不可理喻	不可理喻
不可逆转	不可逆转
不可容忍	不可容忍
不可收拾	不可收拾
不可挽回	不可挽回
不可行	不可行
不可一世	不可一世
不可逾越	不可逾越
不客气	不客气
不宽容	不宽容
不郎不秀	不郎不秀
不冷不热	不冷不热
不理智	不理智
不礼貌	不礼貌
不利于健康	不利于健康
不力	不力
不良	不良
不灵敏	不灵敏
不灵巧	不灵巧
不流行	不流行
不伦不类	不伦不类
不美观	不美观
不妙	不妙
不民主	不民主
不明不白	不明不白
不明显	不明显
不明智	不明智
不名一文	不名一文
不名誉	不名誉
不能解救	不能解救
不能容忍	不能容忍
不宁	不宁
不平等	不平等
不平衡	不平衡
不起眼	不起眼
不起眼儿	不起眼儿
不巧	不巧
不切实际	不切实际
不清不白	不清不白
不清不楚	不清不楚
不清洁	不清洁
不确切	不确切
不仁	不仁
不仁不义	不仁不义
不人道	不人道
不三不四	不三不四
不善	不善
不善交际	不善交际
不善交谈	不善交谈
不甚重要	不甚重要
不慎	不慎
不是味儿	不是味儿
不是滋味儿	不是滋味儿
不适当	不适当
不适宜	不适宜
不适应	不适应
不适于居住	不适于居住
不受欢迎	不受欢迎
不熟练	不熟练
不疼不痒	不疼不痒
不体面	不体面
不痛不痒	不痛不痒
不透明	不透明
不透气	不透气
不妥	不妥
不为人知	不为人知
不卫生	不卫生
不文明	不文明
不文雅	不文雅
不稳定	不稳定
不问青红皂白	不问青红皂白
不问三七二十一	不问三七二十一
不问是非情由	不问是非情由
不显眼	不显眼
不现实	不现实
不相适应	不相适应
不祥	不祥
不详	不详
不详尽	不详尽
不像话	不像话
不消化	不消化
不孝	不孝
不肖	不肖
不协调	不协调
不兴	不兴
不修边幅	不修边幅
不学无术	不学无术
不逊	不逊
不雅	不雅
不雅观	不雅观
不雅致	不雅致
不要紧	不要紧
不一致	不一致
不宜居住	不宜居住
不宜说出口	不宜说出口
不友好	不友好
不友善	不友善
不择手段	不择手段
不真诚	不真诚
不真实	不真实
不贞洁	不贞洁
不正常	不正常
不正当	不正当
不正派	不正派
不正直	不正直
不值得羡慕	不值得羡慕
不值一文	不值一文
不中用	不中用
不重要	不重要
不周	不周
不周到	不周到
不注意	不注意
不着边际	不着边际
不着调	不着调
不足道	不足道
不足挂齿	不足挂齿
不足轻重	不足轻重
不足取	不足取
不足为外人道	不足为外人道
不足为训	不足为训
不羁	不羁
不稂不莠	不稂不莠
不虔诚	不虔诚
才疏学浅	才疏学浅
财迷心窍	财迷心窍
残	残
残败	残败
残暴	残暴
残毒	残毒
残酷	残酷
残酷无情	残酷无情
残虐	残虐
残破	残破
残破不全	残破不全
残缺	残缺
残缺不全	残缺不全
残忍	残忍
残损	残损
惨不忍睹	惨不忍睹
惨淡	惨淡
惨毒	惨毒
惨绝人寰	惨绝人寰
惨苦	惨苦
惨厉	惨厉
惨烈	惨烈
惨痛	惨痛
惨无人道	惨无人道
苍白	苍白
苍白无力	苍白无力
苍凉	苍凉
苍茫	苍茫
操切	操切
糙	糙
草	草
草草	草草
草荒	草荒
草率	草率
草木皆兵	草木皆兵
策略性	策略性
差	差
差点儿	差点儿
差可	差可
豺狼成性	豺狼成性
豺狼当道	豺狼当道
缠手	缠手
颤颤巍巍	颤颤巍巍
颤颤悠悠	颤颤悠悠
颤巍巍	颤巍巍
猖	猖
猖狂	猖狂
长长短短	长长短短
长篇大论	长篇大论
长篇累牍	长篇累牍
长线	长线
超常	超常
超然	超然
朝不保夕	朝不保夕
朝不谋夕	朝不谋夕
朝秦暮楚	朝秦暮楚
朝三暮四	朝三暮四
潮	潮
吵吵闹闹	吵吵闹闹
吵人	吵人
沉闷	沉闷
沉痛	沉痛
沉滞	沉滞
陈	陈
陈腐	陈腐
陈旧	陈旧
成事不足，败事有余	成事不足，败事有余
逞性	逞性
逞性子	逞性子
吃不开	吃不开
吃劲	吃劲
吃力	吃力
吃重	吃重
痴	痴
痴痴	痴痴
痴呆	痴呆
痴呆呆	痴呆呆
痴傻	痴傻
痴愚	痴愚
迟钝	迟钝
侈	侈
侈靡	侈靡
侈糜	侈糜
赤地千里	赤地千里
赤裸裸淫秽	赤裸裸淫秽
赤贫	赤贫
充满危机	充满危机
冲昏头脑	冲昏头脑
丑	丑
丑恶	丑恶
丑陋	丑陋
臭	臭
臭不可闻	臭不可闻
臭哄哄	臭哄哄
臭烘烘	臭烘烘
臭名远扬	臭名远扬
臭名昭彰	臭名昭彰
臭名昭著	臭名昭著
臭气冲天	臭气冲天
臭气熏天	臭气熏天
臭味	臭味
初出茅庐	初出茅庐
出手阔气	出手阔气
触目惊心	触目惊心
穿不出去	穿不出去
穿不得	穿不得
串秧儿	串秧儿
疮痍满目	疮痍满目
蠢	蠢
蠢笨	蠢笨
蠢头蠢脑	蠢头蠢脑
刺鼻	刺鼻
刺耳	刺耳
刺眼	刺眼
次	次
次等	次等
从动	从动
从心所欲	从心所欲
从严	从严
从重	从重
粗	粗
粗暴	粗暴
粗笨	粗笨
粗鄙	粗鄙
粗放	粗放
粗拉	粗拉
粗里粗气	粗里粗气
粗劣	粗劣
粗陋	粗陋
粗鲁	粗鲁
粗率	粗率
粗蛮	粗蛮
粗莽	粗莽
粗浅	粗浅
粗涩	粗涩
粗手笨脚	粗手笨脚
粗疏	粗疏
粗俗	粗俗
粗线条	粗线条
粗心	粗心
粗心大意	粗心大意
粗野	粗野
粗枝大叶	粗枝大叶
粗制滥造	粗制滥造
粗重	粗重
粗拙	粗拙
促狭	促狭
脆弱	脆弱
村气	村气
村野	村野
寸草不生	寸草不生
错	错
错乱	错乱
错误百出	错误百出
错杂	错杂
错综	错综
错综复杂	错综复杂
大	大
大错而特错	大错而特错
大错特错	大错特错
大大咧咧	大大咧咧
大而笨拙	大而笨拙
大而化之	大而化之
大而无当	大而无当
大海捞针	大海捞针
大面额	大面额
大谬不然	大谬不然
大手大脚	大手大脚
大肆	大肆
大摇大摆	大摇大摆
大意	大意
大咧咧	大咧咧
呆	呆
呆板	呆板
呆笨	呆笨
呆痴	呆痴
呆呆	呆呆
呆钝	呆钝
呆气	呆气
呆傻	呆傻
呆头呆脑	呆头呆脑
歹	歹
歹毒	歹毒
带有敌意	带有敌意
殆	殆
怠惰	怠惰
单	单
单薄	单薄
单调枯燥	单调枯燥
单弱	单弱
胆怯	胆怯
胆小	胆小
胆小怕事	胆小怕事
胆小如鼠	胆小如鼠
淡	淡
淡薄	淡薄
淡淡	淡淡
淡而无味	淡而无味
淡漠	淡漠
淡然	淡然
诞	诞
荡	荡
刀光剑影	刀光剑影
蹈常袭故	蹈常袭故
倒胃口	倒胃口
道德败坏	道德败坏
道貌岸然	道貌岸然
德行	德行
德性	德性
得寸进尺	得寸进尺
得陇望蜀	得陇望蜀
得鱼忘筌	得鱼忘筌
灯红酒绿	灯红酒绿
灯火阑珊	灯火阑珊
等而下之	等而下之
等外	等外
等因奉此	等因奉此
低	低
低卑	低卑
低标准	低标准
低层	低层
低档	低档
低等	低等
低端	低端
低级	低级
低贱	低贱
低劣	低劣
低迷	低迷
低能	低能
低人一等	低人一等
低三下四	低三下四
低声下气	低声下气
低俗	低俗
低下	低下
低效	低效
低效能	低效能
低值	低值
低智	低智
低质	低质
滴里嘟噜	滴里嘟噜
敌对	敌对
地位低下	地位低下
地狱般	地狱般
颠倒	颠倒
颠连	颠连
颠三倒四	颠三倒四
凋敝	凋敝
刁	刁
刁恶	刁恶
刁悍	刁悍
刁滑	刁滑
刁赖	刁赖
刁蛮	刁蛮
刁钻	刁钻
刁钻古怪	刁钻古怪
吊儿郎当	吊儿郎当
调皮	调皮
鼎沸	鼎沸
丢魂	丢魂
丢脸	丢脸
丢三落四	丢三落四
东倒西歪	东倒西歪
冬烘	冬烘
动荡	动荡
动荡不安	动荡不安
动魄惊心	动魄惊心
动作迟顿	动作迟顿
毒	毒
毒辣	毒辣
独裁	独裁
独断	独断
度量小	度量小
短浅	短浅
短视	短视
钝	钝
多变	多变
多病	多病
多事	多事
多义	多义
多余	多余
惰	惰
惰性	惰性
讹	讹
恶	恶
恶毒	恶毒
恶贯满盈	恶贯满盈
恶狠狠	恶狠狠
恶煞煞	恶煞煞
恶浊	恶浊
饿殍遍野	饿殍遍野
耳生	耳生
二把刀	二把刀
二五眼	二五眼
发狂	发狂
发腻	发腻
发育不全	发育不全
乏	乏
乏味	乏味
翻手为云，覆手为雨	翻手为云，覆手为雨
翻云覆雨	翻云覆雨
繁复	繁复
繁乱	繁乱
繁难	繁难
繁冗	繁冗
繁琐	繁琐
繁芜	繁芜
繁杂	繁杂
繁重	繁重
繁缛	繁缛
烦	烦
烦难	烦难
烦冗	烦冗
烦琐	烦琐
烦嚣	烦嚣
反	反
反常	反常
反对称	反对称
反反复复	反反复复
反复无常	反复无常
反面	反面
反叛	反叛
反社会	反社会
犯有罪行	犯有罪行
饭桶	饭桶
泛	泛
泛泛	泛泛
放诞	放诞
放荡	放荡
放荡不羁	放荡不羁
放浪	放浪
放肆	放肆
放纵	放纵
菲	菲
菲薄	菲薄
非	非
非法	非法
非分	非分
非婚生	非婚生
非礼	非礼
非人	非人
非生产性	非生产性
非正常	非正常
非正统	非正统
非正义	非正义
废	废
废弛	废弛
废旧	废旧
废物	废物
沸沸扬扬	沸沸扬扬
费	费
费工夫	费工夫
费功夫	费功夫
费劲	费劲
费力	费力
费时	费时
费事	费事
纷	纷
纷繁	纷繁
纷乱	纷乱
纷扰	纷扰
纷杂	纷杂
封闭	封闭
封闭式	封闭式
封闭型	封闭型
封建	封建
锋芒毕露	锋芒毕露
风吹日晒	风吹日晒
风刀霜剑	风刀霜剑
风风火火	风风火火
风流	风流
风骚	风骚
风声鹤唳	风声鹤唳
风雨飘摇	风雨飘摇
疯疯癫癫	疯疯癫癫
疯狂般	疯狂般
疯癫癫	疯癫癫
否	否
否定	否定
肤泛	肤泛
肤皮潦草	肤皮潦草
肤浅	肤浅
浮泛	浮泛
浮光掠影	浮光掠影
浮滑	浮滑
浮皮蹭痒	浮皮蹭痒
浮漂	浮漂
浮浅	浮浅
浮躁	浮躁
浮噪	浮噪
腐败堕落	腐败堕落
腐臭	腐臭
腐恶	腐恶
腐化	腐化
腐化堕落	腐化堕落
腐旧	腐旧
腐烂	腐烂
腐朽	腐朽
腐朽没落	腐朽没落
覆雨翻云	覆雨翻云
复	复
复合	复合
复合式	复合式
复合型	复合型
复杂多变	复杂多变
傅会	傅会
负	负
负面	负面
富余	富余
附会	附会
嘎	嘎
概念化	概念化
干	干
干巴	干巴
干巴巴	干巴巴
干瘪	干瘪
干瘪瘪	干瘪瘪
干干巴巴	干干巴巴
赶尽杀绝	赶尽杀绝
刚愎	刚愎
刚愎自用	刚愎自用
高昂	高昂
高傲	高傲
高不成，低不就	高不成，低不就
高不成低不就	高不成低不就
高成本	高成本
高价	高价
高价位	高价位
高难	高难
高难度	高难度
高压	高压
疙疙瘩瘩	疙疙瘩瘩
疙里疙瘩	疙里疙瘩
隔靴搔痒	隔靴搔痒
勾心斗角	勾心斗角
苟且	苟且
狗眼看人	狗眼看人
垢	垢
够呛	够呛
孤	孤
孤傲	孤傲
孤傲不群	孤傲不群
孤单单	孤单单
孤孤单单	孤孤单单
孤寡	孤寡
孤寂	孤寂
孤立	孤立
孤立无援	孤立无援
孤零零	孤零零
孤陋寡闻	孤陋寡闻
孤僻	孤僻
古怪	古怪
古旧	古旧
古里古怪	古里古怪
固定不变	固定不变
固执	固执
寡	寡
寡淡	寡淡
寡断	寡断
寡了叭叽	寡了叭叽
寡情	寡情
寡味	寡味
寡言	寡言
寡言少语	寡言少语
挂漏	挂漏
挂名	挂名
挂一漏万	挂一漏万
乖谬	乖谬
乖僻	乖僻
乖张	乖张
乖剌	乖剌
乖戾	乖戾
怪里怪气	怪里怪气
怪僻	怪僻
官僚	官僚
官僚主义	官僚主义
光怪陆离	光怪陆离
鬼	鬼
鬼鬼祟祟	鬼鬼祟祟
鬼计多端	鬼计多端
鬼头鬼脑	鬼头鬼脑
诡	诡
诡计多端	诡计多端
诡秘	诡秘
诡诈	诡诈
诡谲	诡谲
过当	过当
过分简单化	过分简单化
过分拥挤	过分拥挤
过河拆桥	过河拆桥
过了气	过了气
过气	过气
过桥抽板	过桥抽板
过时	过时
哈喇	哈喇
孩子气	孩子气
海底捞月	海底捞月
海底捞针	海底捞针
害	害
骇人听闻	骇人听闻
憨	憨
含含糊糊	含含糊糊
含含混混	含含混混
含糊	含糊
含糊不清	含糊不清
含糊其辞	含糊其辞
含糊其词	含糊其词
含混	含混
含混不清	含混不清
含蓄	含蓄
涵蓄	涵蓄
寒	寒
寒苦	寒苦
寒素	寒素
寒酸	寒酸
寒微	寒微
寒伧	寒伧
寒碜	寒碜
悍	悍
悍然	悍然
豪	豪
豪侈	豪侈
豪横	豪横
豪强	豪强
豪奢	豪奢
毫不客气	毫不客气
毫不留情	毫不留情
毫无价值	毫无价值
毫无目标	毫无目标
毫无意义	毫无意义
毫无用处	毫无用处
好容易	好容易
好事多磨	好事多磨
黑	黑
黑沉沉	黑沉沉
黑灯瞎火	黑灯瞎火
黑洞洞	黑洞洞
黑咕隆咚	黑咕隆咚
黑乎乎	黑乎乎
黑茫茫	黑茫茫
黑蒙蒙	黑蒙蒙
黑漆寥光	黑漆寥光
黑漆漆	黑漆漆
黑森森	黑森森
黑心	黑心
黑心肠	黑心肠
黑黝黝	黑黝黝
黑黢黢	黑黢黢
狠	狠
狠毒	狠毒
狠劲	狠劲
狠心	狠心
横	横
横暴	横暴
横加	横加
横蛮无理	横蛮无理
横七竖八	横七竖八
哄然	哄然
猴	猴
后患无穷	后患无穷
后进	后进
呼幺喝六	呼幺喝六
胡	胡
胡里胡涂	胡里胡涂
胡乱	胡乱
胡子拉茬	胡子拉茬
胡子拉碴	胡子拉碴
糊糊涂涂	糊糊涂涂
糊里糊涂	糊里糊涂
虎踞龙蟠	虎踞龙蟠
虎头蛇尾	虎头蛇尾
花插着	花插着
花搭着	花搭着
花花搭搭	花花搭搭
花里胡哨	花里胡哨
花钱浪费	花钱浪费
花拳绣腿	花拳绣腿
花天酒地	花天酒地
哗然	哗然
华	华
华而不实	华而不实
猾	猾
滑	滑
滑头	滑头
滑头滑脑	滑头滑脑
怀着恶意	怀着恶意
坏脾气	坏脾气
坏人当道	坏人当道
幻	幻
幻异	幻异
荒	荒
荒诞	荒诞
荒诞不经	荒诞不经
荒诞派	荒诞派
荒诞无稽	荒诞无稽
荒废	荒废
荒寂	荒寂
荒凉	荒凉
荒乱	荒乱
荒落	荒落
荒谬	荒谬
荒谬绝伦	荒谬绝伦
荒漠	荒漠
荒僻	荒僻
荒弃	荒弃
荒疏	荒疏
荒唐	荒唐
荒唐无稽	荒唐无稽
荒无人烟	荒无人烟
荒芜	荒芜
荒淫	荒淫
荒淫无耻	荒淫无耻
荒淫无度	荒淫无度
荒瘠	荒瘠
晃晃悠悠	晃晃悠悠
晃悠悠	晃悠悠
恍恍惚惚	恍恍惚惚
恍惚	恍惚
谎	谎
灰暗	灰暗
灰沉沉	灰沉沉
灰溜溜	灰溜溜
灰茫茫	灰茫茫
灰蒙蒙	灰蒙蒙
灰色	灰色
灰头灰脸	灰头灰脸
灰头土脸	灰头土脸
灰秃秃	灰秃秃
灰朦朦	灰朦朦
慧黠	慧黠
晦	晦
晦暗	晦暗
晦涩	晦涩
晦冥	晦冥
晦暝	晦暝
秽	秽
秽恶	秽恶
秽乱	秽乱
秽土	秽土
秽亵	秽亵
会来事	会来事
昏	昏
昏暗	昏暗
昏沉	昏沉
昏黑	昏黑
昏乱	昏乱
昏昧	昏昧
昏天黑地	昏天黑地
昏头昏脑	昏头昏脑
昏庸	昏庸
昏愦	昏愦
昏聩	昏聩
婚外	婚外
浑	浑
浑浑噩噩	浑浑噩噩
浑头浑脑	浑头浑脑
浑浊	浑浊
浑噩	浑噩
混	混
混混沌沌	混混沌沌
混交	混交
混淆不清	混淆不清
混血	混血
混账	混账
混浊	混浊
混沌	混沌
火暴	火暴
祸不单行	祸不单行
祸从天降	祸从天降
机变	机变
机械式	机械式
机械性	机械性
畸	畸
畸轻畸重	畸轻畸重
畸形	畸形
积满灰尘	积满灰尘
积重难返	积重难返
鸡零狗碎	鸡零狗碎
鸡毛蒜皮	鸡毛蒜皮
鸡犬不留	鸡犬不留
鸡犬不宁	鸡犬不宁
棘手	棘手
急不可待	急不可待
急功近利	急功近利
急切	急切
急性子	急性子
急于	急于
急躁	急躁
疾言厉色	疾言厉色
挤	挤
挤巴	挤巴
挤得水泄不通	挤得水泄不通
挤得要命	挤得要命
挤挤插插	挤挤插插
挤满	挤满
寂	寂
寂寥	寂寥
忌刻	忌刻
夹七夹八	夹七夹八
家长式	家长式
家贫如洗	家贫如洗
家徒壁立	家徒壁立
家徒四壁	家徒四壁
假冒	假冒
假模假式	假模假式
假仁假义	假仁假义
假想	假想
假惺惺	假惺惺
假意	假意
假造	假造
假正经	假正经
假装神圣	假装神圣
价高	价高
价格不菲	价格不菲
价格高昂	价格高昂
架空	架空
尖刻	尖刻
尖酸	尖酸
尖酸刻薄	尖酸刻薄
尖嘴薄舌	尖嘴薄舌
尖嘴猴腮	尖嘴猴腮
间不容发	间不容发
间杂	间杂
肩摩毂击	肩摩毂击
艰	艰
艰巨	艰巨
艰苦	艰苦
艰苦卓绝	艰苦卓绝
艰难曲折	艰难曲折
艰难险阻	艰难险阻
艰涩	艰涩
艰深	艰深
艰危	艰危
艰辛	艰辛
奸	奸
奸刁	奸刁
奸恶	奸恶
奸猾	奸猾
奸险	奸险
奸邪	奸邪
奸诈	奸诈
奸佞	奸佞
简陋	简陋
简慢	简慢
贱	贱
见不得人	见不得人
见风使舵	见风使舵
见风转舵	见风转舵
见识短浅	见识短浅
见异思迁	见异思迁
剑拔弩张	剑拔弩张
僵	僵
僵化	僵化
僵硬	僵硬
胶柱鼓瑟	胶柱鼓瑟
浇薄	浇薄
浇漓	浇漓
骄	骄
骄傲	骄傲
骄傲自满	骄傲自满
骄横	骄横
骄慢	骄慢
骄气	骄气
骄人	骄人
骄奢淫逸	骄奢淫逸
骄纵	骄纵
骄矜	骄矜
娇	娇
娇痴	娇痴
娇贵	娇贵
娇憨	娇憨
娇嫩	娇嫩
娇气	娇气
娇弱	娇弱
娇生惯养	娇生惯养
矫情造作	矫情造作
矫揉造作	矫揉造作
侥	侥
狡	狡
狡猾	狡猾
狡计多端	狡计多端
狡兔三窟	狡兔三窟
狡诈	狡诈
狡狯	狡狯
狡黠	狡黠
揭不开锅	揭不开锅
竭蹶	竭蹶
洁身自好	洁身自好
结结巴巴	结结巴巴
斤斤计较	斤斤计较
金刚努目	金刚努目
紧	紧
紧巴	紧巴
紧巴巴	紧巴巴
近视	近视
荆棘载途	荆棘载途
惊爆	惊爆
惊人	惊人
惊天动地	惊天动地
惊险	惊险
精力枯竭	精力枯竭
精神不振	精神不振
精神溜号	精神溜号
经济拮据	经济拮据
经验不足	经验不足
静僻	静僻
净余	净余
窘	窘
窘促	窘促
窘急	窘急
窘困	窘困
窘迫	窘迫
窘涩	窘涩
旧	旧
旧式	旧式
拘	拘
拘礼	拘礼
拘执	拘执
狙	狙
拒人于千里之外	拒人于千里之外
剧毒	剧毒
倔	倔
倔强	倔强
倔头倔脑	倔头倔脑
倔犟	倔犟
绝情	绝情
峻	峻
开小差	开小差
坎坷	坎坷
坎坷不平	坎坷不平
看风使舵	看风使舵
糠	糠
亢	亢
靠不住	靠不住
苛	苛
苛刻	苛刻
磕磕绊绊	磕磕绊绊
磕头碰脑	磕头碰脑
可鄙	可鄙
可怖	可怖
可耻	可耻
可恶	可恶
可骇	可骇
可恨	可恨
可惊	可惊
可叹	可叹
可有可无	可有可无
可憎	可憎
刻板	刻板
刻薄	刻薄
刻毒	刻毒
刻舟求剑	刻舟求剑
坑坑洼洼	坑坑洼洼
坑洼	坑洼
坑洼不平	坑洼不平
空	空
空洞	空洞
空洞洞	空洞洞
空洞无聊	空洞无聊
空洞无物	空洞无物
空乏	空乏
空泛	空泛
空幻	空幻
空空洞洞	空空洞洞
空落落	空落落
空头	空头
空虚	空虚
空中楼阁	空中楼阁
抠	抠
抠门儿	抠门儿
抠搜	抠搜
抠唆	抠唆
口蜜腹剑	口蜜腹剑
口是心非	口是心非
口头上	口头上
枯	枯
枯寂	枯寂
枯涩	枯涩
枯燥	枯燥
枯燥乏味	枯燥乏味
枯燥无味	枯燥无味
枯槁	枯槁
苦不唧	苦不唧
苦口	苦口
苦苦	苦苦
苦涩	苦涩
酷烈	酷烈
酷虐	酷虐
夸诞	夸诞
狂	狂
狂傲	狂傲
狂暴	狂暴
狂荡	狂荡
狂妄	狂妄
狂妄自大	狂妄自大
狂躁	狂躁
狂悖	狂悖
狂恣	狂恣
困顿	困顿
困窘	困窘
困苦	困苦
困难	困难
困难重重	困难重重
困人	困人
阔绰	阔绰
阔气	阔气
拉忽	拉忽
拉拉杂杂	拉拉杂杂
拉杂	拉杂
辣	辣
辣手	辣手
来路不明	来路不明
来之不易	来之不易
赖	赖
赖皮	赖皮
懒	懒
懒到极点	懒到极点
懒惰	懒惰
懒散	懒散
烂	烂
滥	滥
狼狈	狼狈
狼狈不堪	狼狈不堪
狼籍	狼籍
狼藉	狼藉
狼心狗肺	狼心狗肺
浪	浪
浪荡	浪荡
劳而无功	劳而无功
老大难	老大难
老掉牙	老掉牙
老赶	老赶
老虎屁股摸不得	老虎屁股摸不得
老奸巨猾	老奸巨猾
老奸巨滑	老奸巨滑
老辣	老辣
老派	老派
老气	老气
老气横秋	老气横秋
老弱病残	老弱病残
老式	老式
老朽	老朽
累卵	累卵
累赘	累赘
累牍连篇	累牍连篇
肋脦	肋脦
冷冰冰	冷冰冰
冷淡	冷淡
冷峻	冷峻
冷酷	冷酷
冷酷无情	冷酷无情
冷冷	冷冷
冷冷清清	冷冷清清
冷厉	冷厉
冷落	冷落
冷门	冷门
冷漠	冷漠
冷峭	冷峭
冷清	冷清
冷清清	冷清清
冷若冰霜	冷若冰霜
冷销	冷销
冷血	冷血
冷噤	冷噤
离索	离索
离题	离题
离心离德	离心离德
理亏	理亏
理屈	理屈
理屈词穷	理屈词穷
理由不充分	理由不充分
里出外进	里出外进
厉	厉
厉声	厉声
利令智昏	利令智昏
利已	利已
利欲熏心	利欲熏心
哩哩啦啦	哩哩啦啦
哩哩罗罗	哩哩罗罗
哩溜歪斜	哩溜歪斜
连篇累牍	连篇累牍
良莠不齐	良莠不齐
两面光	两面光
两面三刀	两面三刀
寥	寥
寥寂	寥寂
潦草	潦草
了不得	了不得
了不起	了不起
烈	烈
烈性子	烈性子
劣	劣
劣等	劣等
劣中之劣	劣中之劣
鳞状	鳞状
凛	凛
凛凛	凛凛
凛然	凛然
吝	吝
吝啬	吝啬
零	零
零丁	零丁
零零散散	零零散散
零零碎碎	零零碎碎
零乱	零乱
零落	零落
零七八碎	零七八碎
零散	零散
零碎	零碎
零星	零星
伶仃	伶仃
凌乱	凌乱
凌杂	凌杂
令人不安	令人不安
令人齿冷	令人齿冷
令人恶心	令人恶心
令人发指	令人发指
令人费解	令人费解
令人寒心	令人寒心
令人敬畏	令人敬畏
令人困倦	令人困倦
令人毛骨悚然	令人毛骨悚然
令人恼火	令人恼火
令人疲倦	令人疲倦
令人生气	令人生气
令人生厌	令人生厌
令人讨厌	令人讨厌
令人厌恶	令人厌恶
令人厌倦	令人厌倦
令人遗憾	令人遗憾
令人折断腰	令人折断腰
令人窒息	令人窒息
令人作呕	令人作呕
溜号	溜号
流里流气	流里流气
流气	流气
六亲不认	六亲不认
娄	娄
漏洞百出	漏洞百出
陋	陋
鲁	鲁
鲁钝	鲁钝
鲁莽	鲁莽
碌	碌
碌碌	碌碌
碌碌无为	碌碌无为
驴唇不对马嘴	驴唇不对马嘴
率	率
率尔	率尔
率然	率然
乱	乱
乱成一团	乱成一团
乱纷纷	乱纷纷
乱哄哄	乱哄哄
乱烘烘	乱烘烘
乱乎	乱乎
乱了营	乱了营
乱乱哄哄	乱乱哄哄
乱虐并生	乱虐并生
乱蓬蓬	乱蓬蓬
乱七八糟	乱七八糟
乱套	乱套
乱腾	乱腾
乱腾腾	乱腾腾
乱杂	乱杂
乱糟糟	乱糟糟
乱真	乱真
乱嘈嘈	乱嘈嘈
落后	落后
落落寡合	落落寡合
落寞	落寞
落市	落市
落俗套	落俗套
落套	落套
落拓	落拓
落伍	落伍
麻	麻
麻痹	麻痹
麻麻黑	麻麻黑
麻木	麻木
麻木不仁	麻木不仁
马虎	马虎
马马虎虎	马马虎虎
埋汰	埋汰
卖不掉	卖不掉
卖不动	卖不动
蛮不讲理	蛮不讲理
蛮悍	蛮悍
蛮横	蛮横
蛮横无理	蛮横无理
蛮荒	蛮荒
满脸横肉	满脸横肉
满目疮痍	满目疮痍
漫	漫
漫不经心	漫不经心
漫不经意	漫不经意
漫无边际	漫无边际
漫无目标	漫无目标
漫无目的	漫无目的
漫漶	漫漶
谩	谩
茫	茫
茫茫	茫茫
茫茫然	茫茫然
盲目	盲目
盲人瞎马	盲人瞎马
莽	莽
莽苍	莽苍
莽莽苍苍	莽莽苍苍
莽莽撞撞	莽莽撞撞
莽撞	莽撞
猫哭老鼠	猫哭老鼠
毛	毛
毛糙	毛糙
毛毛躁躁	毛毛躁躁
毛手毛脚	毛手毛脚
毛头毛脑	毛头毛脑
毛躁	毛躁
冒	冒
冒牌	冒牌
冒失	冒失
冒有风险	冒有风险
貌似强大	貌似强大
貌似真实的	貌似真实的
贸贸然	贸贸然
贸然	贸然
没边儿	没边儿
没出息	没出息
没骨头	没骨头
没关系	没关系
没好气	没好气
没见过世面	没见过世面
没教养	没教养
没劲	没劲
没理	没理
没礼貌	没礼貌
没良心	没良心
没两下子	没两下子
没轻没重	没轻没重
没什么了不得	没什么了不得
没什么了不起	没什么了不起
没受过教育	没受过教育
没头没脑	没头没脑
没头脑	没头脑
没味	没味
没心没肺	没心没肺
没心眼儿	没心眼儿
没意思	没意思
没有教养	没有教养
没有礼貌	没有礼貌
没有头脑	没有头脑
没有学问	没有学问
没有勇气	没有勇气
媚俗	媚俗
闷	闷
闷气	闷气
蒙昧	蒙昧
蒙蒙	蒙蒙
蒙蒙胧胧	蒙蒙胧胧
蒙胧	蒙胧
孟浪	孟浪
靡丽	靡丽
靡靡	靡靡
糜	糜
糜烂	糜烂
迷濛	迷濛
迷宫般	迷宫般
迷糊	迷糊
迷离	迷离
迷离扑朔	迷离扑朔
迷离倘恍	迷离倘恍
迷漫	迷漫
迷茫	迷茫
迷蒙	迷蒙
迷蒙蒙	迷蒙蒙
迷迷糊糊	迷迷糊糊
迷迷茫茫	迷迷茫茫
迷迷蒙蒙	迷迷蒙蒙
迷迷怔怔	迷迷怔怔
弥天	弥天
米珠薪桂	米珠薪桂
秘	秘
密	密
密不透风	密不透风
绵里藏针	绵里藏针
绵软	绵软
勉勉强强	勉勉强强
勉强	勉强
面呈病色	面呈病色
面黄肌瘦	面黄肌瘦
面目可憎	面目可憎
面目狰狞	面目狰狞
面色蜡黄	面色蜡黄
面生	面生
面无表情	面无表情
藐小	藐小
渺	渺
渺茫	渺茫
渺渺	渺渺
渺然	渺然
渺若烟云	渺若烟云
渺小	渺小
灭绝人性	灭绝人性
明哲保身	明哲保身
名不副实	名不副实
名过其实	名过其实
名义	名义
名义上	名义上
名誉扫地	名誉扫地
命苦	命苦
谬	谬
模糊	模糊
模糊不清	模糊不清
模棱两可	模棱两可
摩肩接踵	摩肩接踵
魔鬼般	魔鬼般
魔怔	魔怔
莫须有	莫须有
墨	墨
漠	漠
漠不关心	漠不关心
漠漠	漠漠
漠然	漠然
寞	寞
暮气	暮气
暮气沉沉	暮气沉沉
暮色苍茫	暮色苍茫
幕后	幕后
木	木
木雕泥塑	木雕泥塑
木头木脑	木头木脑
木讷	木讷
目不识丁	目不识丁
目光短浅	目光短浅
目光如豆	目光如豆
目光凶狠	目光凶狠
目空一切	目空一切
目无余子	目无余子
目中无人	目中无人
拿腔拿调	拿腔拿调
拿腔作势	拿腔作势
奶声奶气	奶声奶气
男盗女娼	男盗女娼
难	难
难人	难人
难上加难	难上加难
难上难	难上难
难说话	难说话
难听	难听
难闻	难闻
难相处	难相处
难驯服	难驯服
难以	难以
难以沟通	难以沟通
囊空如洗	囊空如洗
囊中羞涩	囊中羞涩
闹	闹
闹得慌	闹得慌
闹哄哄	闹哄哄
闹闹哄哄	闹闹哄哄
闹闹嚷嚷	闹闹嚷嚷
闹嚷嚷	闹嚷嚷
嫩	嫩
泥沙俱下	泥沙俱下
你死我活	你死我活
匿名	匿名
腻人	腻人
逆	逆
逆耳	逆耳
蔫不唧儿	蔫不唧儿
蔫儿坏	蔫儿坏
蔫头耷脑	蔫头耷脑
拈轻怕重	拈轻怕重
年久失修	年久失修
鸟尽弓藏	鸟尽弓藏
狞	狞
狞恶	狞恶
凝滞	凝滞
泞	泞
牛	牛
牛气	牛气
扭扭捏捏	扭扭捏捏
奴颜婢膝	奴颜婢膝
虐	虐
懦	懦
懦怯	懦怯
懦弱	懦弱
盘根错节	盘根错节
盘陁	盘陁
庞杂	庞杂
旁若无人	旁若无人
配不上	配不上
蓬乱	蓬乱
蓬散	蓬散
蓬首垢面	蓬首垢面
蓬头垢面	蓬头垢面
蓬头散发	蓬头散发
脾气暴	脾气暴
脾气爆躁	脾气爆躁
脾气坏	脾气坏
脾气火暴	脾气火暴
脾气急躁	脾气急躁
皮	皮
皮毛	皮毛
皮相	皮相
僻	僻
僻静	僻静
偏激	偏激
偏颇	偏颇
偏听偏信	偏听偏信
偏狭	偏狭
偏斜	偏斜
偏心	偏心
偏心眼	偏心眼
片断	片断
片面	片面
骗人	骗人
漂浮	漂浮
贫	贫
贫寒	贫寒
贫苦	贫苦
贫困	贫困
贫穷	贫穷
贫瘠	贫瘠
平白	平白
平白无故	平白无故
平淡无奇	平淡无奇
平淡无味	平淡无味
平铺直叙	平铺直叙
平铺直序	平铺直序
凭白无故	凭白无故
凭空	凭空
坡	坡
泼	泼
泼辣	泼辣
婆婆妈妈	婆婆妈妈
破	破
破败	破败
破坏性	破坏性
破旧	破旧
破烂不堪	破烂不堪
破陋	破陋
扑朔迷离	扑朔迷离
铺张	铺张
铺张浪费	铺张浪费
欺诈性	欺诈性
七零八落	七零八落
凄	凄
凄惨	凄惨
凄楚	凄楚
凄寒	凄寒
凄寂	凄寂
凄苦	凄苦
凄冷	凄冷
凄厉	凄厉
凄凉	凄凉
凄迷	凄迷
凄怆	凄怆
漆黑	漆黑
漆黑一团	漆黑一团
其貌不扬	其貌不扬
奇丑无比	奇丑无比
奇形怪状	奇形怪状
崎	崎
崎岖	崎岖
崎岖不平	崎岖不平
起绉	起绉
起褶子	起褶子
岂有此理	岂有此理
气粗	气粗
气闷	气闷
气盛	气盛
气势汹汹	气势汹汹
气壮如牛	气壮如牛
千变万化	千变万化
千疮百孔	千疮百孔
千金一掷	千金一掷
千钧一发	千钧一发
千篇一律	千篇一律
前呼后拥	前呼后拥
潜	潜
浅	浅
浅薄	浅薄
浅尝辄止	浅尝辄止
浅陋	浅陋
欠妥	欠妥
欠完善	欠完善
欠周到	欠周到
强暴	强暴
强横	强横
强行	强行
强制性	强制性
巧	巧
巧黠	巧黠
翘尾巴	翘尾巴
峭	峭
峭直	峭直
怯	怯
怯懦	怯懦
怯然	怯然
怯弱	怯弱
怯生生	怯生生
窃	窃
禽兽不如	禽兽不如
轻	轻
轻淡	轻淡
轻浮	轻浮
轻贱	轻贱
轻狂	轻狂
轻率	轻率
轻描淡写	轻描淡写
轻易	轻易
轻佻	轻佻
倾斜	倾斜
清淡	清淡
清高	清高
清寒	清寒
清苦	清苦
清冷	清冷
清贫	清贫
穷	穷
穷乏	穷乏
穷极潦倒	穷极潦倒
穷苦	穷苦
穷困	穷困
穷困潦倒	穷困潦倒
穷奢极侈	穷奢极侈
穷奢极欲	穷奢极欲
穷酸	穷酸
穷途潦倒	穷途潦倒
穷途末路	穷途末路
穷凶极恶	穷凶极恶
穷匮	穷匮
囚首垢面	囚首垢面
区区	区区
曲曲折折	曲曲折折
曲折	曲折
屈才	屈才
屈理	屈理
犬牙交错	犬牙交错
缺	缺
缺德	缺德
缺乏才智	缺乏才智
缺乏教养	缺乏教养
缺乏绅士风度	缺乏绅士风度
缺乏幽默	缺乏幽默
缺心眼	缺心眼
缺心眼儿	缺心眼儿
群魔乱舞	群魔乱舞
攘攘	攘攘
扰扰	扰扰
绕脖子	绕脖子
人不为己，天诛地灭	人不为己，天诛地灭
人不知，鬼不觉	人不知，鬼不觉
人声鼎沸	人声鼎沸
人声嘈杂	人声嘈杂
人头攒动	人头攒动
人为财死，鸟为食亡	人为财死，鸟为食亡
任重道远	任重道远
任纵	任纵
认死理	认死理
认死理儿	认死理儿
冗	冗
冗余	冗余
冗赘	冗赘
柔弱	柔弱
肉	肉
肉了叭叽	肉了叭叽
肉麻	肉麻
如临大敌	如临大敌
如临深渊	如临深渊
如履薄冰	如履薄冰
乳臭未干	乳臭未干
软	软
软绵绵	软绵绵
软弱	软弱
软弱无力	软弱无力
若明若暗	若明若暗
若隐若现	若隐若现
弱不禁风	弱不禁风
弱不胜衣	弱不胜衣
弱势	弱势
弱小	弱小
弱智	弱智
三天打鱼两天晒网	三天打鱼两天晒网
散	散
散乱	散乱
散漫	散漫
嗓子不好	嗓子不好
丧尽天良	丧尽天良
丧心病狂	丧心病狂
骚	骚
骚乱性	骚乱性
色厉内荏	色厉内荏
色迷迷	色迷迷
色情	色情
涩	涩
涩苦	涩苦
涩滞	涩滞
森	森
杀气腾腾	杀气腾腾
杀人不见血	杀人不见血
杀人不眨眼	杀人不眨眼
杀人如麻	杀人如麻
傻呵呵	傻呵呵
傻乎乎	傻乎乎
傻里瓜唧	傻里瓜唧
傻里傻气	傻里傻气
傻头傻脑	傻头傻脑
山南海北	山南海北
山穷水尽	山穷水尽
闪烁	闪烁
伤风败俗	伤风败俗
伤脑筋	伤脑筋
伤天害理	伤天害理
伤心惨目	伤心惨目
少不更事	少不更事
奢	奢
奢靡	奢靡
奢糜	奢糜
蛇蝎心肠	蛇蝎心肠
涉世不深	涉世不深
身无分文	身无分文
深重	深重
神不知，鬼不觉	神不知，鬼不觉
神不知鬼不觉	神不知鬼不觉
神气活现	神气活现
神气十足	神气十足
神神秘秘	神神秘秘
神志委靡	神志委靡
声名狼藉	声名狼藉
声色俱厉	声色俱厉
生	生
生拉硬拽	生拉硬拽
生涩	生涩
生疏	生疏
生硬	生硬
盛气凌人	盛气凌人
剩余	剩余
失常	失常
失当	失当
失检	失检
失礼	失礼
失去理性	失去理性
失神	失神
失慎	失慎
失实	失实
失宜	失宜
十恶不赦	十恶不赦
十室九空	十室九空
什	什
什锦	什锦
食而不化	食而不化
食而不知其味	食而不知其味
食古不化	食古不化
实属不易	实属不易
使不得	使不得
使人疲劳	使人疲劳
世故	世故
世情冷暖	世情冷暖
世俗	世俗
世态炎凉	世态炎凉
誓不两立	誓不两立
势不两立	势不两立
势利	势利
势利眼	势利眼
嗜杀成性	嗜杀成性
嗜血	嗜血
嗜血成性	嗜血成性
恃才傲物	恃才傲物
手脚不干净	手脚不干净
手紧	手紧
手生	手生
手头紧	手头紧
手无缚鸡之力	手无缚鸡之力
守旧	守旧
守株待兔	守株待兔
瘦	瘦
瘦弱	瘦弱
输理	输理
疏忽	疏忽
疏懒	疏懒
疏松	疏松
书生气	书生气
鼠胆	鼠胆
鼠目寸光	鼠目寸光
数不上	数不上
数不着	数不着
衰弱	衰弱
衰颓	衰颓
水火不相容	水火不相容
水泄不通	水泄不通
水性杨花	水性杨花
水中捞月	水中捞月
瞬息万变	瞬息万变
说不过去	说不过去
说来话长	说来话长
斯文扫地	斯文扫地
私	私
私底下	私底下
私密	私密
私下	私下
私下里	私下里
私自	私自
死板	死板
死板板	死板板
死沉沉	死沉沉
死脑筋	死脑筋
死气沉沉	死气沉沉
死去活来	死去活来
死死	死死
死心塌地	死心塌地
死心眼	死心眼
死心眼儿	死心眼儿
死性	死性
死一般	死一般
死硬	死硬
死有余辜	死有余辜
肆	肆
肆无忌惮	肆无忌惮
肆意	肆意
四大皆空	四大皆空
四面楚歌	四面楚歌
似	似
似是而非	似是而非
松垮	松垮
松垮垮	松垮垮
松散	松散
松散散	松散散
松松垮垮	松松垮垮
耸人听闻	耸人听闻
酥	酥
酥软	酥软
酥松	酥松
俗	俗
俗气	俗气
素不相识	素不相识
素昧平生	素昧平生
肃	肃
肃杀	肃杀
酸	酸
酸不溜丢	酸不溜丢
酸臭	酸臭
酸刻	酸刻
酸溜溜	酸溜溜
酸涩	酸涩
随风倒	随风倒
随风使舵	随风使舵
随风转舵	随风转舵
随随便便	随随便便
随心所欲	随心所欲
碎	碎
祟	祟
损	损
损人利己	损人利己
琐	琐
琐碎	琐碎
琐细	琐细
琐屑	琐屑
索	索
索然	索然
索然乏味	索然乏味
索然寡味	索然寡味
索然无味	索然无味
所谓	所谓
太随便	太随便
太虚	太虚
贪	贪
贪得无厌	贪得无厌
贪婪	贪婪
贪心	贪心
贪心不足	贪心不足
瘫软	瘫软
谈何容易	谈何容易
唐突	唐突
烫手	烫手
淘	淘
淘气	淘气
淘神	淘神
特困	特困
特贫	特贫
体力不支	体力不支
体弱	体弱
体衰	体衰
天昏地暗	天昏地暗
天南地北	天南地北
天南海北	天南海北
恬淡	恬淡
腆	腆
挑逗性	挑逗性
铁杆儿	铁杆儿
铁公鸡一毛不拔	铁公鸡一毛不拔
铁石心肠	铁石心肠
铁血	铁血
听天由命	听天由命
偷	偷
偷工减料	偷工减料
偷偷摸摸	偷偷摸摸
投机	投机
头脑空虚	头脑空虚
头痛	头痛
秃	秃
徒	徒
徒劳	徒劳
徒劳无功	徒劳无功
徒劳无益	徒劳无益
徒然	徒然
土	土
土得掉渣	土得掉渣
土里土气	土里土气
土气	土气
土俗	土俗
土头土脑	土头土脑
兔死狗烹	兔死狗烹
兔子不吃窝边草	兔子不吃窝边草
兔子尾巴长不了	兔子尾巴长不了
颓	颓
颓败	颓败
颓废	颓废
蜕化	蜕化
蜕化变质	蜕化变质
退化	退化
拖泥带水	拖泥带水
拖沓	拖沓
歪	歪
歪歪扭扭	歪歪扭扭
歪斜	歪斜
外面儿光	外面儿光
外行	外行
顽	顽
顽钝	顽钝
顽梗	顽梗
顽固	顽固
顽劣	顽劣
顽皮	顽皮
完全不重要	完全不重要
万花筒似	万花筒似
万马齐喑	万马齐喑
万难	万难
枉	枉
枉费心机	枉费心机
枉然	枉然
望梅止渴	望梅止渴
忘恩负义	忘恩负义
忘情	忘情
妄	妄
妄自尊大	妄自尊大
威	威
威厉	威厉
微不足道	微不足道
微贱	微贱
微茫	微茫
微末	微末
危殆	危殆
危机四伏	危机四伏
危机重重	危机重重
危急	危急
危如累卵	危如累卵
危亡	危亡
危在旦夕	危在旦夕
唯利是图	唯利是图
唯我独尊	唯我独尊
惟利是图	惟利是图
惟我独尊	惟我独尊
为人作嫁	为人作嫁
为人作嫁衣裳	为人作嫁衣裳
为所欲为	为所欲为
萎靡不振	萎靡不振
委靡不振	委靡不振
委琐	委琐
伪	伪
伪善	伪善
伪造	伪造
未便	未便
未成熟	未成熟
未归类	未归类
未揭露	未揭露
未老先衰	未老先衰
未列计划	未列计划
未受过教育	未受过教育
味道不好	味道不好
味同嚼蜡	味同嚼蜡
畏怯	畏怯
畏首畏尾	畏首畏尾
文不对题	文不对题
文弱	文弱
文恬武嬉	文恬武嬉
紊	紊
紊乱	紊乱
问道于盲	问道于盲
窝囊	窝囊
乌沉沉	乌沉沉
乌灯黑火	乌灯黑火
乌洞洞	乌洞洞
乌七八糟	乌七八糟
乌漆墨黑	乌漆墨黑
乌涂	乌涂
乌托邦	乌托邦
乌压压	乌压压
乌烟瘴气	乌烟瘴气
污	污
污秽	污秽
污七八糟	污七八糟
污浊	污浊
无伴	无伴
无表情	无表情
无补	无补
无补于事	无补于事
无常	无常
无诚意	无诚意
无道德观念	无道德观念
无的放矢	无的放矢
无动于衷	无动于衷
无端	无端
无端端	无端端
无法无天	无法无天
无根据	无根据
无故	无故
无关大局	无关大局
无关宏旨	无关宏旨
无关紧要	无关紧要
无关痛痒	无关痛痒
无光	无光
无光泽	无光泽
无规	无规
无涵养	无涵养
无稽	无稽
无济于事	无济于事
无计划	无计划
无记名	无记名
无纪律	无纪律
无价值	无价值
无教养	无教养
无节制	无节制
无可无不可	无可无不可
无口才	无口才
无赖	无赖
无理	无理
无礼	无礼
无力	无力
无眉目	无眉目
无目的	无目的
无能	无能
无能为力	无能为力
无凭无据	无凭无据
无情	无情
无情无义	无情无义
无人过问	无人过问
无人问津	无人问津
无伤大雅	无伤大雅
无生气	无生气
无实效	无实效
无实质	无实质
无所帮助	无所帮助
无所不用其极	无所不用其极
无特色	无特色
无望	无望
无味	无味
无谓	无谓
无吸引力	无吸引力
无限制	无限制
无依无靠	无依无靠
无意义	无意义
无益	无益
无用	无用
无原则	无原则
无缘无故	无缘无故
无证据	无证据
无知	无知
无中生有	无中生有
无助	无助
无足轻重	无足轻重
芜	芜
芜杂	芜杂
武断	武断
误	误
误诊	误诊
稀里糊涂	稀里糊涂
稀松	稀松
稀松平常	稀松平常
喜新厌旧	喜新厌旧
细	细
细碎	细碎
细小	细小
瞎	瞎
下	下
下乘	下乘
下道儿	下道儿
下等	下等
下贱	下贱
下流	下流
下品	下品
下三烂	下三烂
下三滥	下三滥
下作	下作
吓人	吓人
纤弱	纤弱
险	险
险毒	险毒
险恶	险恶
险峻	险峻
险峭	险峭
险象环生	险象环生
险要	险要
险诈	险诈
险阻	险阻
现行	现行
羡余	羡余
香艳	香艳
享乐	享乐
向上倾斜	向上倾斜
向下倾斜	向下倾斜
象征性	象征性
萧	萧
萧然	萧然
萧瑟	萧瑟
萧森	萧森
萧疏	萧疏
萧索	萧索
萧条	萧条
萧飒	萧飒
嚣杂	嚣杂
嚣张	嚣张
消极	消极
小	小
小肚鸡肠	小肚鸡肠
小儿科	小儿科
小家子气	小家子气
小家子相	小家子相
小里小气	小里小气
小气	小气
小手小脚	小手小脚
小小不言	小小不言
小心眼	小心眼
小心眼儿	小心眼儿
笑里藏刀	笑里藏刀
效率很差	效率很差
携贰	携贰
邪	邪
邪恶	邪恶
斜	斜
斜体	斜体
斜歪	斜歪
卸磨杀驴	卸磨杀驴
懈怠	懈怠
辛	辛
辛苦	辛苦
辛酸	辛酸
辛辛苦苦	辛辛苦苦
心不在焉	心不在焉
心粗	心粗
心地狭窄	心地狭窄
心毒	心毒
心浮	心浮
心黑手辣	心黑手辣
心狠	心狠
心狠手辣	心狠手辣
心口不一	心口不一
心切	心切
心如蛇蝎	心如蛇蝎
心如铁石	心如铁石
心胸狭隘	心胸狭隘
心胸狭窄	心胸狭窄
心眼儿小	心眼儿小
心眼儿窄	心眼儿窄
心眼小	心眼小
心猿意马	心猿意马
星星点点	星星点点
腥	腥
腥臭	腥臭
腥臊	腥臊
腥膻	腥膻
形单影只	形单影只
形格势禁	形格势禁
形同路人	形同路人
形同虚设	形同虚设
形影相吊	形影相吊
行不通	行不通
行为不端	行为不端
行为不检	行为不检
性格内向	性格内向
性急	性急
性情急躁	性情急躁
凶	凶
凶巴巴	凶巴巴
凶暴	凶暴
凶残	凶残
凶毒	凶毒
凶恶	凶恶
凶悍	凶悍
凶狠	凶狠
凶横	凶横
凶狂	凶狂
凶蛮	凶蛮
凶猛	凶猛
凶煞	凶煞
凶顽	凶顽
凶险	凶险
凶戾	凶戾
胸无城府	胸无城府
胸无点墨	胸无点墨
熊	熊
虚	虚
虚诞	虚诞
虚浮	虚浮
虚幻	虚幻
虚假	虚假
虚空	虚空
虚夸	虚夸
虚拟	虚拟
虚荣	虚荣
虚弱	虚弱
虚设	虚设
虚妄	虚妄
虚伪	虚伪
虚无	虚无
虚无飘渺	虚无飘渺
虚无缥缈	虚无缥缈
虚虚实实	虚虚实实
虚有其表	虚有其表
虚诈	虚诈
絮	絮
絮叨	絮叨
絮聒	絮聒
喧	喧
喧天	喧天
喧嚣	喧嚣
喧杂	喧杂
喧噪	喧噪
悬	悬
悬乎	悬乎
悬空	悬空
玄	玄
学究气	学究气
学识浅薄	学识浅薄
学识谫陋	学识谫陋
雪上加霜	雪上加霜
血淋淋	血淋淋
血腥	血腥
血雨腥风	血雨腥风
牙碜	牙碜
亚	亚
烟雾弥漫	烟雾弥漫
烟雾腾腾	烟雾腾腾
严	严
严加	严加
严峻	严峻
严苛	严苛
严酷	严酷
严冷	严冷
严厉	严厉
严肃	严肃
严重	严重
言不由衷	言不由衷
言之无物	言之无物
眼巴巴	眼巴巴
眼光短浅	眼光短浅
眼皮子高	眼皮子高
眼皮子浅	眼皮子浅
眼生	眼生
衍	衍
扬长	扬长
羊质虎皮	羊质虎皮
阳奉阴违	阳奉阴违
妖	妖
妖里妖气	妖里妖气
摇摇晃晃	摇摇晃晃
摇摇欲坠	摇摇欲坠
要不得	要不得
野	野
野鸡	野鸡
野蛮	野蛮
叶公好龙	叶公好龙
夜郎自大	夜郎自大
一把死拿	一把死拿
一暴十寒	一暴十寒
一波三折	一波三折
一不小心	一不小心
一场空	一场空
一成不变	一成不变
一触即溃	一触即溃
一发千钧	一发千钧
一锅粥	一锅粥
一脸横肉	一脸横肉
一脸稚气	一脸稚气
一毛不拔	一毛不拔
一偏	一偏
一贫如洗	一贫如洗
一钱不值	一钱不值
一仍旧贯	一仍旧贯
一手遮天	一手遮天
一团乱麻	一团乱麻
一团漆黑	一团漆黑
一团糟	一团糟
一文不名	一文不名
一文不值	一文不值
一窝蜂	一窝蜂
一无可取	一无可取
一无是处	一无是处
一无所长	一无所长
一言堂	一言堂
一掷千金	一掷千金
依违	依违
依稀	依稀
衣衫不整	衣衫不整
颐指气使	颐指气使
疑难	疑难
倚老卖老	倚老卖老
以怨报德	以怨报德
易变	易变
易怒	易怒
臆	臆
意马心猿	意马心猿
义正词严	义正词严
溢价	溢价
异形	异形
荫	荫
因循守旧	因循守旧
殷	殷
殷切	殷切
阴	阴
阴暗	阴暗
阴沉	阴沉
阴沉沉	阴沉沉
阴毒	阴毒
阴恶	阴恶
阴晦	阴晦
阴冷	阴冷
阴凄	阴凄
阴森	阴森
阴森森	阴森森
阴损	阴损
阴险	阴险
阴险毒辣	阴险毒辣
阴性	阴性
阴阳怪气	阴阳怪气
淫	淫
淫荡	淫荡
淫秽	淫秽
淫贱	淫贱
淫乱	淫乱
淫靡	淫靡
淫邪	淫邪
淫逸	淫逸
淫亵	淫亵
淫猥	淫猥
引起反感	引起反感
隐	隐
隐晦	隐晦
隐秘	隐秘
隐然	隐然
隐身	隐身
隐形	隐形
隐性	隐性
隐隐	隐隐
隐隐绰绰	隐隐绰绰
隐隐约约	隐隐约约
隐约	隐约
应名儿	应名儿
影影绰绰	影影绰绰
硬	硬
硬气	硬气
硬生生	硬生生
硬性	硬性
拥挤	拥挤
拥挤不堪	拥挤不堪
庸	庸
庸碌	庸碌
庸俗	庸俗
庸庸碌碌	庸庸碌碌
用不着	用不着
幽	幽
幽暗	幽暗
幽晦	幽晦
幽幽	幽幽
幽冥	幽冥
幽黯	幽黯
优柔	优柔
优柔寡断	优柔寡断
悠谬	悠谬
犹犹豫豫	犹犹豫豫
犹豫不决	犹豫不决
犹豫不前	犹豫不前
油	油
油乎乎	油乎乎
油滑	油滑
油腻腻	油腻腻
油头滑脑	油头滑脑
油汪汪	油汪汪
油脂麻花	油脂麻花
油渍渍	油渍渍
有碍观瞻	有碍观瞻
有弊	有弊
有点旧	有点旧
有毒	有毒
有毒性	有毒性
有害	有害
有名无实	有名无实
有难度	有难度
有伤风化	有伤风化
有失检点	有失检点
有失偏颇	有失偏颇
有失身分	有失身分
有始无终	有始无终
有恃无恐	有恃无恐
有头无尾	有头无尾
有一搭没一搭	有一搭没一搭
有义务	有义务
有罪	有罪
迂	迂
迂腐	迂腐
迂阔	迂阔
迂拙	迂拙
于事无补	于事无补
愚	愚
愚笨	愚笨
愚不可及	愚不可及
愚痴	愚痴
愚蠢	愚蠢
愚钝	愚钝
愚陋	愚陋
愚鲁	愚鲁
愚昧	愚昧
愚昧无知	愚昧无知
愚蒙	愚蒙
愚傻	愚傻
愚顽	愚顽
愚妄	愚妄
愚拙	愚拙
余剩	余剩
逾分	逾分
鱼龙混杂	鱼龙混杂
鱼游釜中	鱼游釜中
与虎谋皮	与虎谋皮
与世隔绝	与世隔绝
与世无争	与世无争
语无伦次	语无伦次
语焉不详	语焉不详
羽毛未丰	羽毛未丰
欲壑难填	欲壑难填
原始	原始
圆	圆
圆滑	圆滑
约略	约略
越轨	越轨
越礼	越礼
云遮雾障	云遮雾障
云谲波诡	云谲波诡
蕴藉	蕴藉
晕头转向	晕头转向
杂	杂
杂草丛生	杂草丛生
杂乱	杂乱
杂乱无章	杂乱无章
杂牌	杂牌
杂七杂八	杂七杂八
杂遝	杂遝
杂沓	杂沓
灾难性	灾难性
在困难中	在困难中
脏	脏
脏乎乎	脏乎乎
脏乱	脏乱
脏兮兮	脏兮兮
糟	糟
凿空	凿空
凿死理儿	凿死理儿
躁	躁
躁急	躁急
躁狂	躁狂
造次	造次
造作	造作
贼溜溜	贼溜溜
贼眉鼠眼	贼眉鼠眼
贼去关门	贼去关门
贼头贼脑	贼头贼脑
扎手	扎手
轧	轧
窄	窄
张冠李戴	张冠李戴
张狂	张狂
招致不幸	招致不幸
照本宣科	照本宣科
狰狞	狰狞
正色	正色
正颜厉色	正颜厉色
枝蔓	枝蔓
支离	支离
支离破碎	支离破碎
直呆呆	直呆呆
直瞪瞪	直瞪瞪
直盯盯	直盯盯
直勾勾	直勾勾
直愣愣	直愣愣
执迷不悟	执迷不悟
执拗	执拗
趾高气扬	趾高气扬
只顾自身利益	只顾自身利益
只听楼梯响，不见人下来	只听楼梯响，不见人下来
纸上谈兵	纸上谈兵
纸醉金迷	纸醉金迷
志大才疏	志大才疏
智障	智障
稚气	稚气
质次价高	质次价高
滞	滞
滞背	滞背
滞钝	滞钝
滞涩	滞涩
滞销	滞销
窒闷	窒闷
重	重
重沓	重沓
众叛亲离	众叛亲离
皱	皱
皱巴	皱巴
皱巴巴	皱巴巴
皱皱巴巴	皱皱巴巴
竹篮打水	竹篮打水
竹篮子打水	竹篮子打水
竹篮子打水一场空	竹篮子打水一场空
煮豆燃萁	煮豆燃萁
主观	主观
主观上	主观上
讆	讆
专横	专横
专横跋扈	专横跋扈
专制	专制
转移性	转移性
装备不良	装备不良
装模作样	装模作样
装腔	装腔
装腔作势	装腔作势
装相	装相
装样子	装样子
赘	赘
赘余	赘余
捉襟见肘	捉襟见肘
捉摸不定	捉摸不定
拙	拙
拙笨	拙笨
拙劣	拙劣
着三不着两	着三不着两
浊	浊
子虚	子虚
子虚乌有	子虚乌有
自傲	自傲
自大	自大
自负	自负
自高自大	自高自大
自豪	自豪
自命不凡	自命不凡
自命清高	自命清高
自恃	自恃
自私	自私
自私自利	自私自利
自相矛盾	自相矛盾
纵恣	纵恣
走神	走神
走油	走油
嘴尖	嘴尖
醉翁之意不在酒	醉翁之意不在酒
最坏	最坏
罪不容诛	罪不容诛
罪大恶极	罪大恶极
罪恶	罪恶
罪恶多端	罪恶多端
罪恶深重	罪恶深重
罪恶滔天	罪恶滔天
罪恶昭彰	罪恶昭彰
罪恶昭著	罪恶昭著
罪该万死	罪该万死
罪孽深重	罪孽深重
左	左
做作	做作
作势	作势
坐而论道	坐而论道
坐井观天	坐井观天
兀突	兀突
孬	孬
噩	噩
卮	卮
孛	孛
啬	啬
啬刻	啬刻
厝火积薪	厝火积薪
赝	赝
剌	剌
剌戾	剌戾
剽悍	剽悍
罔	罔
伧	伧
伧俗	伧俗
佶屈聱牙	佶屈聱牙
侉	侉
佻	佻
俚	俚
俚俗	俚俗
倜然	倜然
倥	倥
倥侗	倥侗
倥偬	倥偬
倨	倨
倨傲	倨傲
傥	傥
僭	僭
儇	儇
巽	巽
亵	亵
羸弱	羸弱
跅弛	跅弛
跅驰	跅驰
冥	冥
冥顽	冥顽
冥顽不化	冥顽不化
冥顽不灵	冥顽不灵
冥冥	冥冥
讷	讷
诎	诎
诘屈聱牙	诘屈聱牙
谫	谫
谫陋	谫陋
谲	谲
谲诈	谲诈
阢	阢
阽	阽
刍	刍
堙	堙
艽	艽
芴	芴
苴	苴
茕	茕
茕茕	茕茕
茕茕孑立	茕茕孑立
茕茕孑立，形影相吊	茕茕孑立，形影相吊
荏	荏
荏弱	荏弱
萋迷	萋迷
迍邅	迍邅
瞢	瞢
拗	拗
拮据	拮据
吆三喝四	吆三喝四
吆五喝六	吆五喝六
咄咄逼人	咄咄逼人
哙	哙
哝	哝
啷	啷
嗲	嗲
嗲声嗲气	嗲声嗲气
嘈	嘈
嘈杂	嘈杂
嘀里嘟噜	嘀里嘟噜
岌岌	岌岌
岌岌不可终日	岌岌不可终日
岌岌可危	岌岌可危
嶙峋	嶙峋
嶙嶙	嶙嶙
犷	犷
犷悍	犷悍
狃	狃
狎	狎
狎昵	狎昵
狯	狯
狷	狷
狷急	狷急
猥	猥
猥鄙	猥鄙
猥贱	猥贱
猥劣	猥劣
猥陋	猥陋
猥琐	猥琐
猥亵	猥亵
獐头鼠目	獐头鼠目
獠	獠
舛	舛
馀	馀
廪	廪
忉	忉
忮	忮
忸忸怩怩	忸忸怩怩
忸怩作态	忸怩作态
怊	怊
恹	恹
恹恹	恹恹
悖	悖
悖晦	悖晦
悖谬	悖谬
悖逆	悖逆
悖妄	悖妄
悭	悭
悭吝	悭吝
悱	悱
愦	愦
愣	愣
愣头愣脑	愣头愣脑
愀然	愀然
愎	愎
慵懒	慵懒
懵	懵
懵懂	懵懂
懵里懵懂	懵里懵懂
懵懵懂懂	懵懵懂懂
阙陋	阙陋
阙略	阙略
湎	湎
溲	溲
溷浊	溷浊
滂	滂
澹然	澹然
蹇	蹇
遴	遴
邋里邋遢	邋里邋遢
邋遢	邋遢
邋邋遢遢	邋邋遢遢
孱	孱
孱弱	孱弱
羼	羼
娆	娆
媸	媸
孑	孑
孑然	孑然
孑然一身	孑然一身
孑身	孑身
驽	驽
驽钝	驽钝
骈枝	骈枝
绌	绌
缈	缈
缛	缛
缥缈	缥缈
缭乱	缭乱
幺麽	幺麽
杌	杌
桀	桀
桀骜不驯	桀骜不驯
棼	棼
槁	槁
轫	轫
辁	辁
暧	暧
暧昧	暧昧
暝	暝
犟	犟
毵毵	毵毵
虢	虢
朦	朦
朦胧	朦胧
朦朦胧胧	朦朦胧胧
臊	臊
膻	膻
膻气	膻气
膻腥	膻腥
熹微	熹微
戾	戾
恝	恝
恝然	恝然
恣	恣
恣肆	恣肆
恣意	恣意
憝	憝
戆	戆
戆头戆脑	戆头戆脑
沓	沓
硗	硗
硗薄	硗薄
硗瘠	硗瘠
睨	睨
瞀	瞀
瞑	瞑
瞽	瞽
锱铢必较	锱铢必较
鸷	鸷
鸷悍	鸷悍
疣赘	疣赘
瘠	瘠
瘠薄	瘠薄
癃	癃
癫狂	癫狂
窈冥	窈冥
窭	窭
窳	窳
窳败	窳败
窳惰	窳惰
窳劣	窳劣
褊	褊
褊急	褊急
褊狭	褊狭
褶	褶
矜	矜
矜持	矜持
矜夸	矜夸
聒	聒
聒噪	聒噪
颛	颛
颛蒙	颛蒙
颟顸	颟顸
蚍蜉撼大树	蚍蜉撼大树
蚍蜉撼树	蚍蜉撼树
蚩	蚩
蜻蜓点水	蜻蜓点水
笃	笃
箪食瓢饮	箪食瓢饮
趄	趄
蹩脚	蹩脚
霭霭	霭霭
龃	龃
龃龉	龃龉
龉	龉
龌	龌
龌龊	龌龊
鲰	鲰
饕	饕
黝	黝
黝暗	黝暗
黝黯	黝黯
黠	黠
黠慧	黠慧
黢	黢
黢黑	黢黑
黩	黩
黪	黪
黯	黯
黯淡	黯淡
黯然	黯然
傒倖	傒倖
忷	忷
恟	恟
懆懆	懆懆
搥胸顿足	搥胸顿足
哀	哀
哀哀切切	哀哀切切
哀愁	哀愁
哀怜	哀怜
哀悯	哀悯
哀戚	哀戚
哀凄	哀凄
哀切	哀切
哀伤	哀伤
哀痛	哀痛
哀痛欲绝	哀痛欲绝
哀怨	哀怨
哀恸	哀恸
哀矜	哀矜
傲视	傲视
懊	懊
懊恨	懊恨
懊悔	懊悔
懊恼	懊恼
懊丧	懊丧
百无聊赖	百无聊赖
败兴	败兴
板脸	板脸
板面孔	板面孔
板起脸	板起脸
板着脸	板着脸
板着面孔	板着面孔
半信半疑	半信半疑
包涵	包涵
包容	包容
褒贬	褒贬
睖睁	睖睁
抱不平	抱不平
抱憾	抱憾
抱憾终身	抱憾终身
抱恨	抱恨
抱恨终生	抱恨终生
抱恨终天	抱恨终天
抱疚	抱疚
抱愧	抱愧
抱歉	抱歉
暴跳	暴跳
暴跳如雷	暴跳如雷
杯弓蛇影	杯弓蛇影
悲	悲
悲哀	悲哀
悲愁	悲愁
悲观失望	悲观失望
悲悯	悲悯
悲戚	悲戚
悲凄	悲凄
悲切	悲切
悲切切	悲切切
悲酸	悲酸
悲天悯人	悲天悯人
悲痛	悲痛
悲痛欲绝	悲痛欲绝
悲怆	悲怆
悲恸	悲恸
悲恻	悲恻
背包袱	背包袱
绷	绷
绷脸	绷脸
绷着脸	绷着脸
鼻酸	鼻酸
鄙薄	鄙薄
鄙弃	鄙弃
鄙夷	鄙夷
鞭挞	鞭挞
贬斥	贬斥
变脸	变脸
变色	变色
变心	变心
表示坏情感	表示坏情感
憋	憋
憋得慌	憋得慌
憋闷	憋闷
憋气	憋气
憋屈	憋屈
憋着一肚子气	憋着一肚子气
勃然大怒	勃然大怒
驳难	驳难
驳议	驳议
不待见	不待见
不甘	不甘
不甘心	不甘心
不顾	不顾
不过意	不过意
不寒而栗	不寒而栗
不好过	不好过
不快	不快
不落忍	不落忍
不满足	不满足
不念旧恶	不念旧恶
不容	不容
不是滋味	不是滋味
不死心	不死心
不同意	不同意
不闻不问	不闻不问
不屑	不屑
不屑一顾	不屑一顾
不屑于	不屑于
不以为然	不以为然
不悦	不悦
不赞成	不赞成
不赞同	不赞同
不忠	不忠
不忠诚	不忠诚
怖	怖
猜忌	猜忌
猜嫌	猜嫌
猜疑	猜疑
惭	惭
惭惶	惭惶
惭愧	惭愧
仓皇失措	仓皇失措
藏奸	藏奸
操心	操心
诧	诧
诧异	诧异
诧愕	诧愕
嘲骂	嘲骂
嘲谑	嘲谑
沉吟	沉吟
沉郁	沉郁
诚惶诚恐	诚惶诚恐
吃不准	吃不准
吃错药	吃错药
吃后悔药	吃后悔药
痴愣	痴愣
持异议	持异议
迟疑	迟疑
迟疑不决	迟疑不决
耻骂	耻骂
斥	斥
斥骂	斥骂
斥责	斥责
踌躇	踌躇
踌躇不决	踌躇不决
踌躇不前	踌躇不前
愁	愁
愁惨	愁惨
愁肠百结	愁肠百结
愁眉不展	愁眉不展
愁眉紧锁	愁眉紧锁
愁眉苦脸	愁眉苦脸
愁眉锁眼	愁眉锁眼
愁闷	愁闷
愁容满面	愁容满面
仇恨	仇恨
仇视	仇视
臭骂	臭骂
出气	出气
出神	出神
吹胡子瞪眼	吹胡子瞪眼
捶胸顿足	捶胸顿足
垂怜	垂怜
垂头丧气	垂头丧气
戳壁脚	戳壁脚
戳脊梁骨	戳脊梁骨
刺打	刺打
蹿火	蹿火
错愕	错愕
打骂	打骂
打入冷宫	打入冷宫
打入十八层地狱	打入十八层地狱
打问号	打问号
打怵	打怵
打憷	打憷
大吃一惊	大吃一惊
大跌眼镜	大跌眼镜
大动肝火	大动肝火
大发雷霆	大发雷霆
大惊失色	大惊失色
大骂	大骂
大失所望	大失所望
呆若木鸡	呆若木鸡
呆怔	呆怔
呆滞	呆滞
呆住	呆住
呆愣愣	呆愣愣
贷	贷
担惊受怕	担惊受怕
担心	担心
胆颤心惊	胆颤心惊
胆寒	胆寒
胆战心惊	胆战心惊
惮	惮
当紧	当紧
当头棒喝	当头棒喝
得饶人处且饶人	得饶人处且饶人
等不及	等不及
等闲视之	等闲视之
瞪眼	瞪眼
低沉	低沉
低落	低落
敌视	敌视
惦	惦
惦挂	惦挂
惦记	惦记
惦念	惦念
掉魂	掉魂
掉以轻心	掉以轻心
跌眼镜	跌眼镜
动肝火	动肝火
动火	动火
动怒	动怒
动气	动气
动摇	动摇
恫	恫
斗	斗
斗争	斗争
堵	堵
堵得慌	堵得慌
堵心	堵心
断肠	断肠
断魂	断魂
顿生疑窦	顿生疑窦
顿足捶胸	顿足捶胸
多虑	多虑
多有微词	多有微词
恶骂	恶骂
扼腕	扼腕
耳热	耳热
发愁	发愁
发狠	发狠
发火	发火
发急	发急
发牢骚	发牢骚
发毛	发毛
发脾气	发脾气
发怔	发怔
发指	发指
发作	发作
发怵	发怵
发愣	发愣
发憷	发憷
发飙	发飙
翻然悔悟	翻然悔悟
烦愁	烦愁
烦闷	烦闷
烦腻	烦腻
烦扰	烦扰
烦神	烦神
烦厌	烦厌
烦忧	烦忧
烦躁	烦躁
反唇相讥	反唇相讥
反感	反感
犯愁	犯愁
犯急	犯急
犯难	犯难
犯疑心病	犯疑心病
犯怵	犯怵
犯憷	犯憷
非常悲哀	非常悲哀
非难	非难
非议	非议
费精神	费精神
费神	费神
忿忿	忿忿
忿忿不平	忿忿不平
忿忿然	忿忿然
忿恨	忿恨
忿怒	忿怒
忿恚	忿恚
忿懑	忿懑
愤愤	愤愤
愤愤不平	愤愤不平
愤愤然	愤愤然
愤恨	愤恨
愤世嫉俗	愤世嫉俗
愤懑	愤懑
讽	讽
付之一笑	付之一笑
负疚	负疚
负气	负气
肝肠寸断	肝肠寸断
感伤	感伤
攻击	攻击
骨鲠在喉	骨鲠在喉
顾忌	顾忌
顾虑	顾虑
顾虑重重	顾虑重重
顾念	顾念
寡欢	寡欢
挂	挂
挂怀	挂怀
挂火	挂火
挂记	挂记
挂虑	挂虑
挂念	挂念
挂牵	挂牵
挂心	挂心
怪罪	怪罪
光火	光火
过不去	过不去
过分操心	过分操心
过虑	过虑
过意不去	过意不去
害臊	害臊
骇	骇
骇怪	骇怪
骇惧	骇惧
骇怕	骇怕
骇然失色	骇然失色
骇异	骇异
骇愕	骇愕
含悲	含悲
含愤	含愤
含恨	含恨
含怒	含怒
含沙射影	含沙射影
含羞	含羞
含怨	含怨
涵容	涵容
寒心	寒心
憾	憾
悍然不顾	悍然不顾
汗颜	汗颜
毫不在乎	毫不在乎
呵	呵
呵斥	呵斥
呵责	呵责
呵叱	呵叱
喝斥	喝斥
喝叱	喝叱
恨	恨
恨入骨髓	恨入骨髓
恨铁不成钢	恨铁不成钢
恨之入骨	恨之入骨
红脸	红脸
红眼	红眼
猴儿急	猴儿急
后顾之忧	后顾之忧
后悔	后悔
后悔莫及	后悔莫及
后怕	后怕
忽视	忽视
狐疑不决	狐疑不决
虎着脸	虎着脸
怀恨	怀恨
怀恨在心	怀恨在心
坏情	坏情
患	患
慌恐	慌恐
皇皇	皇皇
惶	惶
惶惶	惶惶
惶惶不安	惶惶不安
惶惶不可终日	惶惶不可终日
惶惶然	惶惶然
惶惑	惶惑
惶惧	惶惧
惶恐	惶恐
惶恐不安	惶恐不安
惶然	惶然
惶然不安	惶然不安
惶悚	惶悚
惶遽	惶遽
灰心	灰心
灰心丧气	灰心丧气
悔	悔
悔不当初	悔不当初
悔不该	悔不该
悔恨	悔恨
悔悟	悔悟
悔之不及	悔之不及
悔之晚矣	悔之晚矣
悔之无及	悔之无及
魂不附体	魂不附体
魂飞魄散	魂飞魄散
魂飞天外	魂飞天外
火	火
火急火燎	火急火燎
火冒三丈	火冒三丈
火烧火燎	火烧火燎
火头上	火头上
饥不择食	饥不择食
激愤	激愤
讥嘲	讥嘲
讥刺	讥刺
讥讽	讥讽
讥讪	讥讪
讥诮	讥诮
鸡蛋里挑骨头	鸡蛋里挑骨头
极度悲哀	极度悲哀
极度悲伤	极度悲伤
急	急
急巴巴	急巴巴
急急巴巴	急急巴巴
急死	急死
急眼	急眼
疾	疾
嫉恨	嫉恨
悸栗	悸栗
忌	忌
忌惮	忌惮
忌恨	忌恨
见怪	见怪
见罪	见罪
将心比心	将心比心
将信将疑	将信将疑
焦愁	焦愁
焦急	焦急
焦心	焦心
焦炙	焦炙
焦灼	焦灼
娇羞	娇羞
教训	教训
叫苦	叫苦
叫苦不迭	叫苦不迭
叫苦连天	叫苦连天
叫骂	叫骂
叫嚣	叫嚣
解气	解气
借古讽今	借古讽今
介怀	介怀
介意	介意
进退两难	进退两难
进退维谷	进退维谷
惊	惊
惊怖	惊怖
惊诧	惊诧
惊呆	惊呆
惊怪	惊怪
惊骇	惊骇
惊慌	惊慌
惊慌失措	惊慌失措
惊惶	惊惶
惊惧	惊惧
惊恐	惊恐
惊怕	惊怕
惊奇	惊奇
惊奇不已	惊奇不已
惊叹	惊叹
惊疑	惊疑
惊异	惊异
惊悚	惊悚
惊愕	惊愕
揪心	揪心
疚愧	疚愧
拘束	拘束
举棋不定	举棋不定
沮	沮
沮丧	沮丧
惧	惧
惧怕	惧怕
眷顾	眷顾
觉得自己理亏	觉得自己理亏
开炮	开炮
看扁	看扁
看不惯	看不惯
看不开	看不开
看不起	看不起
看不上	看不上
看不上眼	看不上眼
看不顺眼	看不顺眼
看淡	看淡
看低	看低
看轻	看轻
苛察	苛察
苛责	苛责
可惜	可惜
恐	恐
恐慌	恐慌
恐惧	恐惧
口诛笔伐	口诛笔伐
哭丧着脸	哭丧着脸
哭笑不得	哭笑不得
苦闷	苦闷
苦恼	苦恼
宽贷	宽贷
宽假	宽假
宽免	宽免
宽赦	宽赦
宽恕	宽恕
宽宥	宽宥
狂怒	狂怒
亏心	亏心
愧	愧
愧对	愧对
愧汗	愧汗
愧恨	愧恨
愧悔	愧悔
愧疚	愧疚
愧怍	愧怍
愧恧	愧恧
愧赧	愧赧
困迫	困迫
拉不下脸	拉不下脸
拉不下脸来	拉不下脸来
拉长个脸	拉长个脸
拉下脸	拉下脸
拉下脸来	拉下脸来
来火	来火
来气	来气
懒洋洋	懒洋洋
劳神	劳神
老羞成怒	老羞成怒
冷嘲热讽	冷嘲热讽
怜	怜
怜悯	怜悯
怜惜	怜惜
怜恤	怜恤
脸红脖子粗	脸红脖子粗
脸红耳热	脸红耳热
脸皮薄	脸皮薄
脸上下不来	脸上下不来
凉	凉
两难	两难
亮红灯	亮红灯
谅	谅
谅解	谅解
虑	虑
乱了方寸	乱了方寸
骂	骂
骂不绝口	骂不绝口
骂大街	骂大街
骂得狗血淋头	骂得狗血淋头
骂得狗血喷头	骂得狗血喷头
骂街	骂街
骂骂咧咧	骂骂咧咧
骂娘	骂娘
骂人	骂人
埋没	埋没
埋怨	埋怨
满不在乎	满不在乎
满脸愁雾	满脸愁雾
漫骂	漫骂
谩骂	谩骂
毛骨悚然	毛骨悚然
冒火	冒火
没个好脸	没个好脸
没精打采	没精打采
没有好脸	没有好脸
闷沉沉	闷沉沉
闷闷	闷闷
闷闷不乐	闷闷不乐
闷郁	闷郁
面斥	面斥
面带怒色	面带怒色
面带嗔色	面带嗔色
面面相觑	面面相觑
面如死灰	面如死灰
面如土色	面如土色
面无人色	面无人色
面有愧色	面有愧色
面有难色	面有难色
面有愠色	面有愠色
藐视	藐视
蔑	蔑
蔑视	蔑视
民怨沸腾	民怨沸腾
悯	悯
鸣不平	鸣不平
鸣冤叫屈	鸣冤叫屈
摸不准	摸不准
磨不开	磨不开
抹不开	抹不开
漠然视之	漠然视之
漠然置之	漠然置之
漠视	漠视
木然	木然
目瞪口呆	目瞪口呆
纳罕	纳罕
难堪	难堪
难为情	难为情
恼	恼
恼恨	恼恨
恼火	恼火
恼怒	恼怒
恼羞成怒	恼羞成怒
闹脾气	闹脾气
闹情绪	闹情绪
闹性子	闹性子
馁	馁
内疚	内疚
腻烦	腻烦
腻歪	腻歪
腻味	腻味
捏把汗	捏把汗
捏一把汗	捏一把汗
怒	怒
怒不可遏	怒不可遏
怒斥	怒斥
怒冲冲	怒冲冲
怒发冲冠	怒发冲冠
怒喝	怒喝
怒火冲天	怒火冲天
怒火中烧	怒火中烧
怒骂	怒骂
怒目	怒目
怒气冲冲	怒气冲冲
怒气冲天	怒气冲天
怒形于色	怒形于色
怒叱	怒叱
怕	怕
怕生	怕生
怕羞	怕羞
拍案而起	拍案而起
排揎	排揎
徘徊	徘徊
派不是	派不是
旁敲侧击	旁敲侧击
抨	抨
抨击	抨击
批	批
批斗	批斗
苶	苶
皮里阳秋	皮里阳秋
屁滚尿流	屁滚尿流
偏废	偏废
品头论足	品头论足
评头论足	评头论足
评头品足	评头品足
颇有微词	颇有微词
破口大骂	破口大骂
魄散魂飞	魄散魂飞
戚戚	戚戚
戚然	戚然
七窍生烟	七窍生烟
凄惶	凄惶
凄切	凄切
凄然	凄然
凄酸	凄酸
凄婉	凄婉
凄怨	凄怨
凄恻	凄恻
歧视	歧视
骑虎难下	骑虎难下
起疑心	起疑心
气	气
气昂昂	气昂昂
气不忿	气不忿
气不过	气不过
气不平	气不平
气冲冲	气冲冲
气冲牛斗	气冲牛斗
气短	气短
气忿	气忿
气忿忿	气忿忿
气愤愤	气愤愤
气鼓鼓	气鼓鼓
气狠狠	气狠狠
气哼哼	气哼哼
气呼呼	气呼呼
气乎乎	气乎乎
气急败坏	气急败坏
气恼	气恼
气馁	气馁
气头上	气头上
气汹汹	气汹汹
牵念	牵念
迁怒	迁怒
谴	谴
谴责	谴责
歉然	歉然
歉甚	歉甚
瞧不起	瞧不起
瞧不上	瞧不上
瞧不上眼	瞧不上眼
切齿	切齿
切齿痛恨	切齿痛恨
怯阵	怯阵
轻忽	轻忽
轻看	轻看
轻蔑	轻蔑
轻视	轻视
清算	清算
穷极无聊	穷极无聊
饶	饶
饶人	饶人
饶恕	饶恕
惹气	惹气
人身攻击	人身攻击
忍让	忍让
柔肠百结	柔肠百结
柔肠寸断	柔肠寸断
如泣如诉	如泣如诉
如丧考妣	如丧考妣
如鲠在喉	如鲠在喉
辱骂	辱骂
撒气	撒气
三心二意	三心二意
丧胆	丧胆
丧魂落魄	丧魂落魄
丧气	丧气
丧志	丧志
扫兴	扫兴
杀气	杀气
傻眼	傻眼
伤	伤
伤悲	伤悲
伤怀	伤怀
伤神	伤神
慑	慑
申斥	申斥
申讨	申讨
申饬	申饬
深恶痛绝	深恶痛绝
深以为异	深以为异
声讨	声讨
生恐	生恐
生怕	生怕
生气	生气
生疑	生疑
失悔	失悔
失节	失节
失意	失意
使性子	使性子
示不满	示不满
示不同意	示不同意
示怒	示怒
势成骑虎	势成骑虎
视同儿戏	视同儿戏
视同蝼蚁	视同蝼蚁
首鼠两端	首鼠两端
受窘	受窘
疏	疏
数落	数落
数说	数说
恕	恕
恕宥	恕宥
说	说
说不	说不
说风凉话	说风凉话
说怪话	说怪话
酸楚	酸楚
缩头缩脑	缩头缩脑
谈虎色变	谈虎色变
讨	讨
提心吊胆	提心吊胆
啼笑皆非	啼笑皆非
体谅	体谅
体念	体念
体惜	体惜
体恤	体恤
天怒人怨	天怒人怨
挑刺儿	挑刺儿
挑毛病	挑毛病
同病相怜	同病相怜
同情	同情
痛不欲生	痛不欲生
痛斥	痛斥
痛恶	痛恶
痛恨	痛恨
痛骂	痛骂
痛惜	痛惜
痛心	痛心
痛心疾首	痛心疾首
痛责	痛责
兔死狐悲	兔死狐悲
颓靡	颓靡
颓然	颓然
颓丧	颓丧
颓唐	颓唐
唾骂	唾骂
挖苦	挖苦
玩	玩
玩忽	玩忽
玩世不恭	玩世不恭
惋	惋
惋惜	惋惜
万箭穿心	万箭穿心
万念俱灰	万念俱灰
往心里去	往心里去
望而生畏	望而生畏
微愠	微愠
唯恐	唯恐
惟恐	惟恐
为难	为难
萎靡	萎靡
委决不下	委决不下
委靡	委靡
委罪	委罪
畏	畏
畏忌	畏忌
畏惧	畏惧
畏葸	畏葸
闻风丧胆	闻风丧胆
问心有愧	问心有愧
窝火	窝火
窝气	窝气
窝心	窝心
无地自容	无地自容
无精打采	无精打采
无名火起	无名火起
无视	无视
无心	无心
物伤其类	物伤其类
惜	惜
系	系
系念	系念
戏侮	戏侮
下不来台	下不来台
下不了台	下不了台
衔恨	衔恨
衔冤	衔冤
嫌	嫌
嫌恶	嫌恶
嫌厌	嫌厌
嫌憎	嫌憎
想不开	想不开
向隅	向隅
向隅而泣	向隅而泣
消沉	消沉
小看	小看
小瞧	小瞧
小视	小视
笑骂	笑骂
泄劲	泄劲
泄气	泄气
心胆俱裂	心胆俱裂
心烦	心烦
心烦意乱	心烦意乱
心寒	心寒
心灰意懒	心灰意懒
心灰意冷	心灰意冷
心急	心急
心急火燎	心急火燎
心急如焚	心急如焚
心急如火	心急如火
心焦	心焦
心焦如焚	心焦如焚
心惊胆颤	心惊胆颤
心惊胆战	心惊胆战
心惊肉跳	心惊肉跳
心里堵得慌	心里堵得慌
心情沉重	心情沉重
心如刀割	心如刀割
心如刀绞	心如刀绞
心如死灰	心如死灰
心酸	心酸
心碎	心碎
心虚	心虚
心绪沉落	心绪沉落
心有余悸	心有余悸
杏眼圆睁	杏眼圆睁
羞	羞
羞惭	羞惭
羞答答	羞答答
羞恶	羞恶
羞窘	羞窘
羞愧	羞愧
羞怯	羞怯
羞人	羞人
羞人答答	羞人答答
羞涩	羞涩
羞羞答答	羞羞答答
羞于	羞于
羞臊	羞臊
羞赧	羞赧
虚惊	虚惊
嘘	嘘
恤	恤
絮烦	絮烦
悬念	悬念
悬系	悬系
悬心	悬心
训斥	训斥
训戒	训戒
训诫	训诫
讶	讶
讶然	讶然
讶然失色	讶然失色
讶异	讶异
厌	厌
厌恶	厌恶
厌烦	厌烦
厌恨	厌恨
厌倦	厌倦
厌腻	厌腻
厌气	厌气
厌弃	厌弃
摇摆	摇摆
要紧	要紧
一怒之下	一怒之下
一气之下	一气之下
一怔	一怔
疑	疑
疑惑	疑惑
疑忌	疑忌
疑虑	疑虑
疑虑重重	疑虑重重
疑神疑鬼	疑神疑鬼
抑郁	抑郁
抑郁寡欢	抑郁寡欢
意意思思	意意思思
义愤	义愤
义愤填膺	义愤填膺
异	异
阴郁	阴郁
引咎	引咎
引咎自责	引咎自责
隐忧	隐忧
幽忧	幽忧
忧	忧
忧愁	忧愁
忧烦	忧烦
忧愤	忧愤
忧惧	忧惧
忧虑	忧虑
忧闷	忧闷
忧思	忧思
忧心	忧心
忧心如焚	忧心如焚
忧心忡忡	忧心忡忡
忧郁	忧郁
忧怨	忧怨
忧悒	忧悒
犹疑	犹疑
犹豫	犹豫
油煎火燎	油煎火燎
游移	游移
有愧	有愧
于心有愧	于心有愧
虞	虞
郁	郁
郁郁不乐	郁郁不乐
郁郁寡欢	郁郁寡欢
欲哭无泪	欲哭无泪
詟	詟
原	原
原谅	原谅
原宥	原宥
怨	怨
怨恨	怨恨
怨悔	怨悔
怨声载道	怨声载道
怨天尤人	怨天尤人
在乎	在乎
糟心	糟心
责	责
责备	责备
责斥	责斥
责怪	责怪
责骂	责骂
责难	责难
责怨	责怨
憎	憎
憎恶	憎恶
憎恨	憎恨
咋舌	咋舌
炸	炸
瞻前顾后	瞻前顾后
战兢兢	战兢兢
战战兢兢	战战兢兢
张口结舌	张口结舌
找茬	找茬
找茬儿	找茬儿
找碴	找碴
找碴儿	找碴儿
找岔子	找岔子
针砭	针砭
震	震
震惊	震惊
震怒	震怒
震悚	震悚
睁一眼闭一眼	睁一眼闭一眼
睁一只眼闭一只眼	睁一只眼闭一只眼
睁只眼闭只眼	睁只眼闭只眼
怔	怔
怔神儿	怔神儿
怔怔	怔怔
怔住	怔住
怔忪	怔忪
直眉瞪眼	直眉瞪眼
指斥	指斥
指鸡骂狗	指鸡骂狗
指桑骂槐	指桑骂槐
指责	指责
指摘	指摘
置疑	置疑
置于脑后	置于脑后
置之不顾	置之不顾
置之不理	置之不理
置之度外	置之度外
置之脑后	置之脑后
滞呆	滞呆
周恤	周恤
咒	咒
咒骂	咒骂
咒诅	咒诅
抓瞎	抓瞎
椎心泣血	椎心泣血
追悔	追悔
追悔莫及	追悔莫及
着急	着急
着忙	着忙
自暴自弃	自暴自弃
自惭形秽	自惭形秽
自咎	自咎
自疚	自疚
自馁	自馁
自怨自艾	自怨自艾
自责	自责
诅	诅
诅骂	诅骂
诅咒	诅咒
左右两难	左右两难
左右为难	左右为难
做贼心虚	做贼心虚
作难	作难
作色	作色
讪讪	讪讪
诃	诃
诘	诘
诟	诟
诟病	诟病
诮	诮
诶	诶
谇	谇
谪	谪
矍	矍
菀	菀
葸	葸
奚落	奚落
奚幸	奚幸
尴尬	尴尬
挹	挹
掎	掎
掊	掊
掊击	掊击
摭	摭
撸	撸
撺	撺
叱	叱
叱骂	叱骂
叱责	叱责
哓	哓
呲	呲
啧有烦言	啧有烦言
嗔	嗔
嗔斥	嗔斥
嗔怪	嗔怪
嗔怒	嗔怒
嗤之以鼻	嗤之以鼻
嘀咕	嘀咕
噍	噍
彷	彷
彷徨	彷徨
忏	忏
忏悔	忏悔
怃	怃
怄	怄
怄气	怄气
忡	忡
怅	怅
怅恨	怅恨
怅然	怅然
怅然若失	怅然若失
怅怅	怅怅
怅惘	怅惘
怆	怆
怆怳	怆怳
怆恍	怆恍
怆然	怆然
怆恻	怆恻
忪	忪
忸	忸
忸怩	忸怩
怵	怵
怵然	怵然
怵头	怵头
怛	怛
怏	怏
怏然	怏然
怏然不悦	怏然不悦
怏怏	怏怏
怏怏不乐	怏怏不乐
怍	怍
怫	怫
怫然	怫然
怫然不悦	怫然不悦
怫然作色	怫然作色
恸	恸
恻	恻
恻然	恻然
恻隐	恻隐
恂	恂
悚	悚
悚然	悚然
悒	悒
悒闷	悒闷
悒郁	悒郁
悒郁寡欢	悒郁寡欢
悒悒不乐	悒悒不乐
悛	悛
悻然	悻然
悻悻	悻悻
悻悻然	悻悻然
惝恍	惝恍
惘	惘
惘然	惘然
惘然若失	惘然若失
惆	惆
惆怅	惆怅
愠	愠
愠怒	愠怒
愕	愕
愕然	愕然
愣神儿	愣神儿
愣怔	愣怔
愣怔怔	愣怔怔
愣住	愣住
惴	惴
愀	愀
慊	慊
憷	憷
憷头	憷头
懔	懔
忝	忝
闵	闵
渎	渎
宥	宥
骞	骞
嬉笑怒骂	嬉笑怒骂
槁木死灰	槁木死灰
殚	殚
轸	轸
戟指	戟指
腼腆	腼腆
膈应	膈应
恝置	恝置
恚	恚
恚愤	恚愤
恚恨	恚恨
恚怒	恚怒
恧	恧
愍	愍
懑	懑
瞠目结舌	瞠目结舌
瞠然	瞠然
詈	詈
詈骂	詈骂
瘅	瘅
竦	竦
赧	赧
赧然	赧然
赧颜	赧颜
踟	踟
踟躇	踟躇
踟蹰	踟蹰
踟蹰不前	踟蹰不前
蹰	蹰
觖	觖
觖望	觖望
訾议	訾议
黯然神伤	黯然神伤
黯然销魂	黯然销魂
侻	侻
俶傥	俶傥
劼	劼
嫕	嫕
惇	惇
惓惓	惓惓
會	會
牣	牣
皞	皞
挨边	挨边
哀婉	哀婉
哀艳	哀艳
蔼	蔼
蔼蔼	蔼蔼
蔼然	蔼然
蔼然可亲	蔼然可亲
蔼如	蔼如
艾	艾
碍事	碍事
安	安
安安静静	安安静静
安安稳稳	安安稳稳
安定	安定
安顿	安顿
安分	安分
安好	安好
安康	安康
安澜	安澜
安乐	安乐
安宁	安宁
安然	安然
安然无事	安然无事
安然无恙	安然无恙
安如磐石	安如磐石
安如泰山	安如泰山
安生	安生
安适	安适
安泰	安泰
安恬	安恬
安稳	安稳
安详	安详
安逸	安逸
安谧	安谧
按期	按期
按时	按时
昂昂	昂昂
昂藏	昂藏
昂然	昂然
傲然	傲然
奥	奥
奥博	奥博
奥妙	奥妙
巴结	巴结
拔尖	拔尖
拔尖儿	拔尖儿
拔俗	拔俗
把牢	把牢
把稳	把稳
把细	把细
白纸黑字	白纸黑字
百不一失	百不一失
百读不厌	百读不厌
百废俱兴	百废俱兴
百里挑一	百里挑一
百炼成钢	百炼成钢
百听不厌	百听不厌
百无一失	百无一失
百依百顺	百依百顺
百折不回	百折不回
百折不挠	百折不挠
百折不挠地	百折不挠地
板板正正	板板正正
板实	板实
板正	板正
半公开	半公开
半透明	半透明
膀大腰圆	膀大腰圆
膀阔腰圆	膀阔腰圆
棒	棒
磅礴	磅礴
苞	苞
睆	睆
保存良好	保存良好
保皇	保皇
保准	保准
饱学	饱学
宝	宝
宝贵	宝贵
悲壮	悲壮
倍儿棒	倍儿棒
备细	备细
奔放	奔放
笨鸟先飞	笨鸟先飞
逼真	逼真
笔挺	笔挺
笔直	笔直
毕恭毕敬	毕恭毕敬
毖	毖
闭月羞花	闭月羞花
必不可少	必不可少
必要	必要
辟	辟
鞭辟近里	鞭辟近里
鞭辟入里	鞭辟入里
便	便
便当	便当
便民	便民
变通	变通
辩证	辩证
标定	标定
彪炳	彪炳
彪炳千古	彪炳千古
彪炳史册	彪炳史册
彪悍	彪悍
彪形	彪形
彪壮	彪壮
表观	表观
表里如一	表里如一
表里一致	表里一致
别具匠心	别具匠心
别具一格	别具一格
别开生面	别开生面
别有风味	别有风味
别有情趣	别有情趣
彬	彬
彬彬	彬彬
彬彬有礼	彬彬有礼
斌	斌
兵强马壮	兵强马壮
冰肌玉骨	冰肌玉骨
冰清玉洁	冰清玉洁
冰雪聪明	冰雪聪明
秉持公正	秉持公正
秉公	秉公
秉正	秉正
秉直	秉直
炳	炳
并茂	并茂
波光粼粼	波光粼粼
波澜壮阔	波澜壮阔
博大	博大
博大精深	博大精深
博古通今	博古通今
博识	博识
博闻	博闻
博闻广识	博闻广识
博闻强记	博闻强记
博学	博学
博学多才	博学多才
博学多能	博学多能
博学多闻	博学多闻
博雅	博雅
勃	勃
勃勃	勃勃
勃勃生机	勃勃生机
不卑不亢	不卑不亢
不变	不变
不耻下问	不耻下问
不大不小	不大不小
不大离儿	不大离儿
不惮其烦	不惮其烦
不动摇	不动摇
不费吹灰之力	不费吹灰之力
不费力	不费力
不苟	不苟
不苟言笑	不苟言笑
不含糊	不含糊
不会腐败	不会腐败
不会弄错	不会弄错
不加区别	不加区别
不加掩饰	不加掩饰
不加渲染	不加渲染
不简单	不简单
不骄不躁	不骄不躁
不咎既往	不咎既往
不亢不卑	不亢不卑
不可或缺	不可或缺
不可缺	不可缺
不可缺少	不可缺少
不赖	不赖
不离儿	不离儿
不落俗套	不落俗套
不落窠臼	不落窠臼
不难	不难
不偏不倚	不偏不倚
不屈	不屈
不屈不挠	不屈不挠
不容怀疑	不容怀疑
不容置辩	不容置辩
不容置疑	不容置疑
不俗	不俗
不同凡响	不同凡响
不同寻常	不同寻常
不为已甚	不为已甚
不畏艰险	不畏艰险
不无道理	不无道理
不无小补	不无小补
不无裨益	不无裨益
不武断	不武断
不限	不限
不懈	不懈
不懈怠	不懈怠
不泄气	不泄气
不言而喻	不言而喻
不厌其烦	不厌其烦
不厌其详	不厌其详
不在话下	不在话下
不争	不争
不整齐	不整齐
不知疲倦	不知疲倦
部优	部优
才高八斗	才高八斗
才华横溢	才华横溢
才略过人	才略过人
才气横溢	才气横溢
才思敏捷	才思敏捷
财大气粗	财大气粗
灿	灿
灿烂	灿烂
灿烂夺目	灿烂夺目
灿亮	灿亮
灿然	灿然
苍郁	苍郁
缠绵	缠绵
昌	昌
昌明	昌明
常	常
常规	常规
长	长
长治久安	长治久安
敞开	敞开
敞开儿	敞开儿
敞口	敞口
敞亮	敞亮
畅达	畅达
畅顺	畅顺
超拔	超拔
超尘拔俗	超尘拔俗
超等	超等
超凡入圣	超凡入圣
超凡脱俗	超凡脱俗
超级	超级
超绝	超绝
超群	超群
超群绝伦	超群绝伦
超俗	超俗
超俗绝世	超俗绝世
超逸	超逸
超卓	超卓
朝气勃勃	朝气勃勃
朝气蓬勃	朝气蓬勃
车水马龙	车水马龙
澈	澈
沉寂	沉寂
沉静	沉静
沉稳	沉稳
沉毅	沉毅
沉鱼落雁	沉鱼落雁
沉着	沉着
称身	称身
成	成
成器	成器
成趣	成趣
澄	澄
澄碧	澄碧
澄澈	澄澈
澄净	澄净
澄明	澄明
澄清	澄清
诚	诚
诚恳	诚恳
诚朴	诚朴
诚心	诚心
诚心诚意	诚心诚意
诚挚	诚挚
诚笃	诚笃
承平	承平
吃得开	吃得开
持平	持平
持正不阿	持正不阿
持之有故	持之有故
持重	持重
驰名	驰名
驰誉	驰誉
赤	赤
赤忱	赤忱
赤诚	赤诚
赤胆	赤胆
赤胆忠心	赤胆忠心
赤裸裸	赤裸裸
赤色	赤色
赤心	赤心
炽盛	炽盛
崇	崇
崇高	崇高
初生牛犊般	初生牛犊般
出类拔萃	出类拔萃
出身高贵	出身高贵
出身名门	出身名门
出神入化	出神入化
出手不凡	出手不凡
出手大方	出手大方
出以公心	出以公心
出众	出众
楚楚	楚楚
楚楚动人	楚楚动人
楚楚可怜	楚楚可怜
楚楚可人	楚楚可人
传神	传神
窗明几净	窗明几净
创造性	创造性
春光明媚	春光明媚
春秋鼎盛	春秋鼎盛
春秋正富	春秋正富
春色满园	春色满园
春意融融	春意融融
醇	醇
醇和	醇和
醇厚	醇厚
醇美	醇美
醇浓	醇浓
醇朴	醇朴
醇香	醇香
唇红齿白	唇红齿白
淳	淳
淳厚	淳厚
淳美	淳美
淳朴	淳朴
纯	纯
纯粹	纯粹
纯厚	纯厚
纯洁	纯洁
纯朴	纯朴
纯熟	纯熟
纯一	纯一
纯真	纯真
纯挚	纯挚
纯种	纯种
绰约	绰约
绰约多姿	绰约多姿
慈	慈
慈悲	慈悲
慈悲为怀	慈悲为怀
慈祥	慈祥
瓷实	瓷实
聪慧	聪慧
聪敏	聪敏
聪明过人	聪明过人
聪明绝顶	聪明绝顶
聪明伶俐	聪明伶俐
聪悟	聪悟
聪颖	聪颖
葱葱	葱葱
葱茂	葱茂
葱郁	葱郁
葱茏	葱茏
从宽	从宽
从轻	从轻
从权	从权
从实	从实
从始至终	从始至终
从头到底	从头到底
从头到尾	从头到尾
从头至尾	从头至尾
从一而终	从一而终
粗豪	粗豪
粗实	粗实
粗中有细	粗中有细
粗壮	粗壮
簇新	簇新
催人奋进	催人奋进
脆	脆
脆亮	脆亮
脆美	脆美
脆生	脆生
脆响	脆响
粹	粹
粹白	粹白
错落有致	错落有致
达	达
达观	达观
打心底里	打心底里
打心眼儿里	打心眼儿里
打心眼里	打心眼里
打眼	打眼
大慈大悲	大慈大悲
大大方方	大大方方
大胆泼辣	大胆泼辣
大度	大度
大而全	大而全
大功率	大功率
大公无私	大公无私
大好	大好
大红大紫	大红大紫
大吉	大吉
大吉大利	大吉大利
大名鼎鼎	大名鼎鼎
大无畏	大无畏
大有文章	大有文章
大有希望	大有希望
大有益处	大有益处
大有作为	大有作为
大有裨益	大有裨益
带劲	带劲
带修辞色彩	带修辞色彩
单刀直入	单刀直入
单一	单一
胆大	胆大
淡泊	淡泊
淡泊明志	淡泊明志
淡泊名利	淡泊名利
淡雅	淡雅
当	当
当红	当红
当面	当面
当仁不让	当仁不让
当心	当心
当众	当众
到	到
道不拾遗	道不拾遗
道道地地	道道地地
道地	道地
得当	得当
得法	得法
得力	得力
得势	得势
得体	得体
得天独厚	得天独厚
得心应手	得心应手
得宜	得宜
灯火辉煌	灯火辉煌
灯火通明	灯火通明
登峰造极	登峰造极
等内	等内
低价位	低价位
低廉	低廉
低首下心	低首下心
滴水不漏	滴水不漏
滴水穿石	滴水穿石
地动山摇	地动山摇
地覆天翻	地覆天翻
第一流	第一流
典型性	典型性
调和	调和
调谐	调谐
跌荡	跌荡
跌宕	跌宕
叠翠	叠翠
秾	秾
秾艳	秾艳
丁是丁，卯是卯	丁是丁，卯是卯
顶刮刮	顶刮刮
顶尖	顶尖
顶事	顶事
顶数	顶数
顶天立地	顶天立地
顶用	顶用
顶呱呱	顶呱呱
鼎鼎大名	鼎鼎大名
定	定
懂礼	懂礼
懂事	懂事
懂行	懂行
动平衡	动平衡
动人心魄	动人心魄
动人心弦	动人心弦
动态各异	动态各异
动态平衡	动态平衡
动听	动听
斗胆	斗胆
豆腐心	豆腐心
逗	逗
逗人	逗人
独出心裁	独出心裁
独到	独到
独具慧眼	独具慧眼
独具匠心	独具匠心
独具特色	独具特色
独具只眼	独具只眼
度量大	度量大
端	端
端端正正	端端正正
端方	端方
端静	端静
端丽	端丽
端平	端平
端秀	端秀
端雅	端雅
端整	端整
端正	端正
端直	端直
端重	端重
端庄	端庄
短平快	短平快
短小精悍	短小精悍
断然	断然
对	对
对称	对称
对号	对号
对劲儿	对劲儿
对头	对头
对味儿	对味儿
墩墩实实	墩墩实实
敦	敦
敦敦实实	敦敦实实
敦厚	敦厚
敦实	敦实
多才多艺	多才多艺
多彩	多彩
多快好省	多快好省
多劳多得	多劳多得
多情	多情
多情善感	多情善感
多姿	多姿
多姿多采	多姿多采
夺目	夺目
扼要	扼要
恩爱	恩爱
恩恩爱爱	恩恩爱爱
耳聪目明	耳聪目明
耳熟	耳熟
耳熟能详	耳熟能详
耳闻目睹	耳闻目睹
尔雅	尔雅
二话不说	二话不说
二话没说	二话没说
发人深省	发人深省
发人深思	发人深思
发育完全	发育完全
发自肺腑	发自肺腑
发噱	发噱
法定	法定
翻天覆地	翻天覆地
繁花似锦	繁花似锦
繁茂	繁茂
繁荣富强	繁荣富强
繁盛	繁盛
芳	芳
芳香	芳香
方方正正	方方正正
方正	方正
放之四海而皆准	放之四海而皆准
菲菲	菲菲
非常耐久	非常耐久
非常热心	非常热心
非同小可	非同小可
飞快	飞快
肥	肥
肥美	肥美
肥沃	肥沃
匪夷所思	匪夷所思
芬芳	芬芳
芬芳袭人	芬芳袭人
芬芳馥郁	芬芳馥郁
芬香	芬香
分秒必争	分秒必争
分文不取	分文不取
分析纯	分析纯
奋勇	奋勇
丰	丰
丰茂	丰茂
丰美	丰美
丰饶	丰饶
丰润	丰润
丰实	丰实
丰沃	丰沃
丰裕	丰裕
丰姿绰约	丰姿绰约
丰腴	丰腴
锋快	锋快
风度翩翩	风度翩翩
风发	风发
风风光光	风风光光
风光如画	风光如画
风光旖旎	风光旖旎
风华正茂	风华正茂
风景如画	风景如画
风流倜傥	风流倜傥
风靡	风靡
风平浪静	风平浪静
风起云涌	风起云涌
风趣	风趣
风行	风行
风雅	风雅
风雨无阻	风雨无阻
风姿绰约	风姿绰约
奉公守法	奉公守法
凤毛麟角	凤毛麟角
扶疏	扶疏
服服帖帖	服服帖帖
服帖	服帖
福如东海	福如东海
富	富
富贵	富贵
富甲一方	富甲一方
富可敌国	富可敌国
富丽	富丽
富丽堂皇	富丽堂皇
富饶	富饶
富实	富实
富庶	富庶
富有	富有
富有成果	富有成果
富有成效	富有成效
富有弹性	富有弹性
富裕	富裕
富足	富足
妇孺皆知	妇孺皆知
盖了帽	盖了帽
盖帽	盖帽
干脆利落	干脆利落
干干净净	干干净净
干净利落	干净利落
干练	干练
甘	甘
甘醇	甘醇
甘美	甘美
甘美多汁	甘美多汁
甘甜	甘甜
甘味	甘味
甘之如饴	甘之如饴
肝胆过人	肝胆过人
敢	敢
刚	刚
刚好	刚好
刚健	刚健
刚劲	刚劲
刚劲有力	刚劲有力
刚强	刚强
刚毅	刚毅
刚硬	刚硬
刚正	刚正
刚正不阿	刚正不阿
刚直	刚直
刚直不阿	刚直不阿
纲领性	纲领性
高	高
高标号	高标号
高标准	高标准
高超	高超
高纯	高纯
高大	高大
高档化	高档化
高等	高等
高等级	高等级
高风峻节	高风峻节
高风亮节	高风亮节
高高手儿	高高手儿
高级化	高级化
高洁	高洁
高精度	高精度
高精尖	高精尖
高妙	高妙
高明	高明
高强	高强
高强度	高强度
高人一等	高人一等
高山流水	高山流水
高尚	高尚
高深	高深
高深莫测	高深莫测
高屋建瓴	高屋建瓴
高效能	高效能
高效益	高效益
高新	高新
高雅	高雅
高雅简朴	高雅简朴
高瞻远瞩	高瞻远瞩
高质量	高质量
高姿态	高姿态
膏腴	膏腴
革命	革命
革命性	革命性
个性鲜明	个性鲜明
各得其所	各得其所
根本	根本
根深蒂固	根深蒂固
根深柢固	根深柢固
跟脚	跟脚
更优越	更优越
耿	耿
耿耿	耿耿
耿介	耿介
耿介不阿	耿介不阿
耿直	耿直
梗直	梗直
工工整整	工工整整
工巧	工巧
工稳	工稳
工细	工细
工整	工整
工致	工致
功不可没	功不可没
功德无量	功德无量
恭	恭
恭恭敬敬	恭恭敬敬
恭谨	恭谨
恭敬	恭敬
恭顺	恭顺
公	公
公道	公道
公而忘私	公而忘私
公平正直	公平正直
公然	公然
公允	公允
公正	公正
公正客观	公正客观
巩固	巩固
勾魂	勾魂
勾魂摄魄	勾魂摄魄
够格	够格
够水平	够水平
够味儿	够味儿
够意思	够意思
鼓舞人心	鼓舞人心
古道热肠	古道热肠
古朴	古朴
古色古香	古色古香
古香古色	古香古色
骨鲠	骨鲠
固	固
固定	固定
固若金汤	固若金汤
乖	乖
乖觉	乖觉
乖巧	乖巧
关键性	关键性
管教好	管教好
管事	管事
管事儿	管事儿
管用	管用
光	光
光彩	光彩
光彩夺目	光彩夺目
光彩照人	光彩照人
光彩炫目	光彩炫目
光灿	光灿
光灿灿	光灿灿
光风霁月	光风霁月
光滑滑	光滑滑
光辉	光辉
光辉灿烂	光辉灿烂
光洁	光洁
光可鉴人	光可鉴人
光亮	光亮
光亮亮	光亮亮
光溜	光溜
光溜溜	光溜溜
光芒万丈	光芒万丈
光明磊落	光明磊落
光明正大	光明正大
光荣	光荣
光润	光润
光闪闪	光闪闪
光鲜	光鲜
光艳	光艳
光耀	光耀
广远	广远
瑰	瑰
瑰丽	瑰丽
瑰伟	瑰伟
瑰玮	瑰玮
规范	规范
鬼斧神工	鬼斧神工
贵重	贵重
滚瓜烂熟	滚瓜烂熟
国色天香	国色天香
国泰民安	国泰民安
国优	国优
果	果
果断	果断
果敢	果敢
果决	果决
过得硬	过得硬
过谦	过谦
过细	过细
过硬	过硬
海枯石烂	海枯石烂
憨厚	憨厚
憨实	憨实
憨直	憨直
含情	含情
含情脉脉	含情脉脉
含义明确	含义明确
豪放	豪放
豪放不羁	豪放不羁
豪华型	豪华型
豪迈	豪迈
豪爽	豪爽
豪壮	豪壮
豪宕	豪宕
毫不动摇	毫不动摇
毫不费力	毫不费力
毫不利己	毫不利己
毫不畏惧	毫不畏惧
毫不犹豫	毫不犹豫
毫发不差	毫发不差
毫发不爽	毫发不爽
毫发无损	毫发无损
毫厘不差	毫厘不差
毫厘不爽	毫厘不爽
毫无保留地	毫无保留地
毫无错误	毫无错误
毫无问题	毫无问题
毫无疑义	毫无疑义
好办	好办
好端端	好端端
好过	好过
好好	好好
好客	好客
好上加好	好上加好
好声好气	好声好气
好生生	好生生
好受	好受
好说话	好说话
好说话儿	好说话儿
好玩儿	好玩儿
好笑	好笑
好心肠	好心肠
好心好意	好心好意
浩	浩
浩大	浩大
浩荡	浩荡
浩然	浩然
和	和
和蔼	和蔼
和蔼可亲	和蔼可亲
和畅	和畅
和风细雨	和风细雨
和和睦睦	和和睦睦
和和气气	和和气气
和缓	和缓
和睦	和睦
和气	和气
和洽	和洽
和软	和软
和善	和善
和声	和声
和顺	和顺
和婉	和婉
和祥	和祥
和颜悦色	和颜悦色
和易	和易
和悦	和悦
合当	合当
合度	合度
合法	合法
合乎逻辑	合乎逻辑
合口	合口
合口味	合口味
合拍	合拍
合情合理	合情合理
合情理	合情理
合群	合群
合时	合时
合胃口	合胃口
合宜	合宜
赫	赫
赫赫	赫赫
赫赫有名	赫赫有名
赫然	赫然
鹤发童颜	鹤发童颜
鹤立鸡群	鹤立鸡群
黑白分明	黑白分明
很有抱负	很有抱负
很有意义	很有意义
狠狠	狠狠
恒	恒
恒定	恒定
恒量	恒量
哄闹	哄闹
鸿	鸿
洪	洪
宏	宏
宏大	宏大
宏富	宏富
宏丽	宏丽
宏赡	宏赡
宏伟	宏伟
弘	弘
弘大	弘大
红	红
红得发紫	红得发紫
红红火火	红红火火
红火	红火
红旗	红旗
猴儿精	猴儿精
厚	厚
厚道	厚道
后生可畏	后生可畏
呼之欲出	呼之欲出
虎背熊腰	虎背熊腰
虎虎生气	虎虎生气
花繁叶茂	花繁叶茂
花好月圆	花好月圆
花气袭人	花气袭人
花容玉貌	花容玉貌
花容月貌	花容月貌
花哨	花哨
花团锦簇	花团锦簇
花香鸟语	花香鸟语
花样翻新	花样翻新
花枝招展	花枝招展
华贵	华贵
滑不唧溜	滑不唧溜
滑稽	滑稽
滑溜	滑溜
滑溜溜	滑溜溜
滑腻	滑腻
滑润	滑润
滑爽	滑爽
滑天下之大稽	滑天下之大稽
划时代	划时代
划一	划一
划一不二	划一不二
欢蹦乱跳	欢蹦乱跳
欢洽	欢洽
欢实	欢实
焕	焕
黄熟	黄熟
煌	煌
煌煌	煌煌
晃眼	晃眼
回味无穷	回味无穷
慧	慧
慧眼独具	慧眼独具
会	会
绘声绘色	绘声绘色
绘声绘影	绘声绘影
绘影绘声	绘影绘声
婚生	婚生
浑厚	浑厚
浑金璞玉	浑金璞玉
浑朴	浑朴
浑然一体	浑然一体
浑身是胆	浑身是胆
浑俗和光	浑俗和光
豁	豁
豁达	豁达
豁达大度	豁达大度
豁亮	豁亮
豁然	豁然
活	活
活便	活便
活泛	活泛
活灵活现	活灵活现
活络	活络
活生生	活生生
活跃	活跃
货真价实	货真价实
基	基
基部	基部
基础	基础
基础性	基础性
基础扎实	基础扎实
机动	机动
机警	机警
机灵	机灵
机敏	机敏
机巧	机巧
机智	机智
积极	积极
激动人心	激动人心
激进	激进
鸡犬不惊	鸡犬不惊
吉	吉
吉利	吉利
吉庆	吉庆
吉祥如意	吉祥如意
吉星高照	吉星高照
极好	极好
极其流行	极其流行
极神圣	极神圣
及格	及格
急公好义	急公好义
急进	急进
技高一筹	技高一筹
济	济
济事	济事
寂静	寂静
寂然	寂然
记实	记实
既定	既定
既往不咎	既往不咎
嘉	嘉
佳	佳
佳丽	佳丽
家给人足	家给人足
家喻户晓	家喻户晓
加意	加意
甲等	甲等
甲级	甲级
价值连城	价值连城
价值千金	价值千金
驾轻就熟	驾轻就熟
坚	坚
坚不可摧	坚不可摧
坚持不懈	坚持不懈
坚持不渝	坚持不渝
坚定	坚定
坚定不移	坚定不移
坚固	坚固
坚固耐用	坚固耐用
坚强不屈	坚强不屈
坚忍	坚忍
坚忍不拔	坚忍不拔
坚韧	坚韧
坚韧不拔	坚韧不拔
坚如磐石	坚如磐石
坚实	坚实
坚挺	坚挺
坚毅	坚毅
坚贞	坚贞
坚贞不屈	坚贞不屈
坚贞不渝	坚贞不渝
尖	尖
尖端	尖端
尖利	尖利
尖锐	尖锐
简	简
简便	简便
简便易行	简便易行
简单化	简单化
简单明了	简单明了
简单易行	简单易行
简短	简短
简括	简括
简练	简练
简略	简略
简明	简明
简明扼要	简明扼要
简朴	简朴
简要	简要
简易	简易
俭	俭
俭朴	俭朴
俭省	俭省
贱价	贱价
见多识广	见多识广
见机	见机
见所未见	见所未见
见微知萌	见微知萌
见微知著	见微知著
健	健
健步	健步
健康美	健康美
健朗	健朗
健美	健美
健全	健全
健实	健实
健硕	健硕
健旺	健旺
健壮	健壮
建设性	建设性
奖罚分明	奖罚分明
讲究	讲究
讲理	讲理
讲礼貌	讲礼貌
匠心独具	匠心独具
娇滴滴	娇滴滴
娇好	娇好
娇丽	娇丽
娇美	娇美
娇媚	娇媚
娇柔	娇柔
娇艳	娇艳
娇娆	娇娆
矫健	矫健
矫捷	矫捷
脚踏实地	脚踏实地
较真	较真
较真儿	较真儿
叫真	叫真
叫真儿	叫真儿
节俭	节俭
节节	节节
节省	节省
节约	节约
杰	杰
捷	捷
竭诚	竭诚
洁	洁
洁净	洁净
结结实实	结结实实
结实粗壮	结实粗壮
筋道	筋道
金碧辉煌	金碧辉煌
金壁辉煌	金壁辉煌
金不换	金不换
金灿灿	金灿灿
金城汤池	金城汤池
金风送爽	金风送爽
金贵	金贵
金晃晃	金晃晃
金闪闪	金闪闪
金玉	金玉
金玉满堂	金玉满堂
紧紧	紧紧
紧要	紧要
锦	锦
锦簇花团	锦簇花团
锦绣	锦绣
谨	谨
谨慎	谨慎
谨严	谨严
谨言慎行	谨言慎行
谨饬	谨饬
近便	近便
尽可能	尽可能
尽人皆知	尽人皆知
尽如人意	尽如人意
尽善尽美	尽善尽美
尽心	尽心
尽心竭力	尽心竭力
尽心尽力	尽心尽力
劲	劲
兢兢业业	兢兢业业
晶	晶
晶莹	晶莹
晶莹剔透	晶莹剔透
精	精
精辟	精辟
精采	精采
精彩纷呈	精彩纷呈
精诚	精诚
精粹	精粹
精打细算	精打细算
精当	精当
精到	精到
精雕细刻	精雕细刻
精干	精干
精光	精光
精悍	精悍
精精神神	精精神神
精力充沛	精力充沛
精练	精练
精良	精良
精密	精密
精妙	精妙
精明	精明
精明强干	精明强干
精巧	精巧
精确	精确
精深	精深
精神百倍	精神百倍
精神饱满	精神饱满
精神抖擞	精神抖擞
精神焕发	精神焕发
精神十足	精神十足
精神矍铄	精神矍铄
精卫填海	精卫填海
精湛	精湛
精制	精制
精壮	精壮
精准	精准
经	经
经常性	经常性
经济宽裕	经济宽裕
经久耐用	经久耐用
经心	经心
经验丰富	经验丰富
经意	经意
经用	经用
井井有条	井井有条
井然	井然
井然有序	井然有序
警	警
景气	景气
景色优美	景色优美
静	静
静寂	静寂
静穆	静穆
静悄	静悄
静悄悄	静悄悄
静态	静态
静幽幽	静幽幽
敬	敬
靖	靖
净	净
炯	炯
炯炯	炯炯
炯炯有神	炯炯有神
究其实	究其实
久经考验	久经考验
拘谨	拘谨
居高临下	居高临下
举止大方	举止大方
举止端庄	举止端庄
举止文雅	举止文雅
举足轻重	举足轻重
据实	据实
具有历史意义	具有历史意义
具有吸引力	具有吸引力
具有压倒性优势	具有压倒性优势
俱佳	俱佳
娟	娟
娟娟	娟娟
娟秀	娟秀
决定性	决定性
决绝	决绝
决然	决然
绝好	绝好
绝佳	绝佳
绝了	绝了
绝妙	绝妙
绝色	绝色
均	均
均等	均等
均衡	均衡
均一	均一
钧	钧
俊	俊
俊丽	俊丽
俊美	俊美
俊俏	俊俏
俊秀	俊秀
开诚布公	开诚布公
开阔	开阔
开门见山	开门见山
开明	开明
开拓型	开拓型
慨	慨
慨然	慨然
堪称第一	堪称第一
堪称一绝	堪称一绝
康	康
康健	康健
康乐	康乐
康泰	康泰
考究	考究
靠得住	靠得住
可歌可泣	可歌可泣
可观	可观
可贵	可贵
可嘉	可嘉
可敬	可敬
可靠	可靠
可亲	可亲
可圈可点	可圈可点
可塑	可塑
可统一	可统一
可喜	可喜
可笑	可笑
可心	可心
可信	可信
可信赖	可信赖
可信任	可信任
可以信赖	可以信赖
可意	可意
刻苦	刻苦
刻意	刻意
客观	客观
客观上	客观上
客气	客气
肯干	肯干
恳	恳
恳切	恳切
恳挚	恳挚
空灵	空灵
空前	空前
空前绝后	空前绝后
口紧	口紧
扣人心弦	扣人心弦
苦口婆心	苦口婆心
苦心	苦心
苦心孤诣	苦心孤诣
快	快
快刀斩乱麻	快刀斩乱麻
快人快语	快人快语
宽	宽
宽大	宽大
宽洪	宽洪
宽宏	宽宏
宽宏大量	宽宏大量
宽厚	宽厚
宽怀	宽怀
宽容	宽容
宽松	宽松
款洽	款洽
匡	匡
狂放	狂放
狂乱	狂乱
狂热	狂热
旷达	旷达
阔	阔
来得	来得
来劲	来劲
来者不拒	来者不拒
烂漫	烂漫
烂熟	烂熟
朗	朗
劳苦功高	劳苦功高
牢	牢
牢固	牢固
牢靠	牢靠
牢牢	牢牢
牢稳	牢稳
老成	老成
老成练达	老成练达
老诚	老诚
老当益壮	老当益壮
老到	老到
老而弥坚	老而弥坚
老练	老练
老马识途	老马识途
老谋深算	老谋深算
老牌	老牌
老于世故	老于世故
乐善好施	乐善好施
乐天	乐天
雷打不动	雷打不动
磊落	磊落
理所当然	理所当然
理想化	理想化
理性	理性
理智	理智
礼节性	礼节性
礼貌	礼貌
礼貌性	礼貌性
丽	丽
历历	历历
历历可数	历历可数
历史性	历史性
利	利
利齿	利齿
利害攸关	利害攸关
利口	利口
利落	利落
利索	利索
利他	利他
利嘴	利嘴
力透纸背	力透纸背
廉	廉
廉洁	廉洁
廉洁奉公	廉洁奉公
廉明	廉明
练达	练达
良好	良好
良善	良善
良性	良性
两袖清风	两袖清风
亮	亮
亮光光	亮光光
亮晃晃	亮晃晃
亮晶晶	亮晶晶
亮亮堂堂	亮亮堂堂
亮闪闪	亮闪闪
亮堂	亮堂
亮堂堂	亮堂堂
亮锃锃	亮锃锃
了当	了当
了然	了然
料事如神	料事如神
琳琅满目	琳琅满目
淋漓	淋漓
淋漓尽致	淋漓尽致
玲珑	玲珑
玲珑剔透	玲珑剔透
伶俐	伶俐
灵	灵
灵便	灵便
灵光	灵光
灵活	灵活
灵活机动	灵活机动
灵捷	灵捷
灵快	灵快
灵敏	灵敏
灵巧	灵巧
灵透	灵透
灵秀	灵秀
灵验	灵验
令人大开眼界	令人大开眼界
令人高兴	令人高兴
令人鼓舞	令人鼓舞
令人满意	令人满意
令人钦佩	令人钦佩
令人神往	令人神往
令人羡慕	令人羡慕
令人信服	令人信服
令人瞩目	令人瞩目
溜	溜
溜光	溜光
溜光水滑	溜光水滑
溜滑	溜滑
留心	留心
流芳百世	流芳百世
流芳后世	流芳后世
流芳千古	流芳千古
流利	流利
龙飞凤舞	龙飞凤舞
龙腾虎跃	龙腾虎跃
隆	隆
炉火纯青	炉火纯青
露骨	露骨
路不拾遗	路不拾遗
路人皆知	路人皆知
履险如夷	履险如夷
率真	率真
率直	率直
锣鼓喧天	锣鼓喧天
落落大方	落落大方
落拓不羁	落拓不羁
麻利	麻利
麻麻亮	麻麻亮
脉脉	脉脉
脉脉含情	脉脉含情
满口	满口
满腔热忱	满腔热忱
满腔热情	满腔热情
满腔热血	满腔热血
满园春色	满园春色
曼	曼
曼妙	曼妙
慢条斯理	慢条斯理
莽莽	莽莽
茂	茂
茂密	茂密
茂盛	茂盛
冒尖	冒尖
没错儿	没错儿
没的说	没的说
没分开	没分开
没弄脏	没弄脏
没说的	没说的
没有搀杂	没有搀杂
没有负担	没有负担
没有说的	没有说的
没有拖累	没有拖累
没有阻碍	没有阻碍
眉清目秀	眉清目秀
美不胜收	美不胜收
美轮美奂	美轮美奂
美满	美满
美貌	美貌
美味可口	美味可口
媚人	媚人
弥足珍贵	弥足珍贵
蜜	蜜
密切	密切
绵和	绵和
绵密	绵密
绵甜	绵甜
免票	免票
面善	面善
面熟	面熟
妙	妙
妙不可言	妙不可言
妙趣横生	妙趣横生
民主	民主
敏	敏
敏慧	敏慧
敏捷	敏捷
敏锐	敏锐
敏悟	敏悟
明	明
明白了当	明白了当
明白无误	明白无误
明摆着	明摆着
明灿灿	明灿灿
明畅	明畅
明澈	明澈
明处	明处
明窗净几	明窗净几
明达	明达
明晃晃	明晃晃
明慧	明慧
明火执仗	明火执仗
明净	明净
明快	明快
明快生动	明快生动
明朗	明朗
明朗朗	明朗朗
明理	明理
明丽	明丽
明亮	明亮
明亮亮	明亮亮
明了	明了
明码	明码
明媚	明媚
明面	明面
明面上	明面上
明明	明明
明明白白	明明白白
明目张胆	明目张胆
明人不做暗事	明人不做暗事
明文	明文
明晰	明晰
明细	明细
明艳	明艳
明智	明智
明睿	明睿
名	名
名不虚传	名不虚传
名垂千古	名垂千古
名垂青史	名垂青史
名副其实	名副其实
名贵	名贵
名牌	名牌
名声大	名声大
名声大振	名声大振
名实相符	名实相符
名特优	名特优
名特优新	名特优新
名誉	名誉
名正言顺	名正言顺
摩登	摩登
莫测高深	莫测高深
目光炯炯	目光炯炯
目光如炬	目光如炬
目光远大	目光远大
目光灼灼	目光灼灼
目无全牛	目无全牛
睦	睦
穆	穆
拿手	拿手
耐穿	耐穿
耐久	耐久
耐人寻味	耐人寻味
难能可贵	难能可贵
内敛	内敛
内向	内向
内向型	内向型
内行	内行
内秀	内秀
能	能
能动	能动
能干	能干
蔫不出溜	蔫不出溜
蔫不溜	蔫不溜
蔫不悄儿	蔫不悄儿
蔫不声	蔫不声
年富力强	年富力强
年高德劭	年高德劭
鸟语花香	鸟语花香
凝	凝
凝神	凝神
凝重	凝重
宁	宁
浓丽	浓丽
浓香	浓香
浓艳	浓艳
怕事	怕事
排场	排场
排列有序	排列有序
排列整齐	排列整齐
判断正确	判断正确
配得上	配得上
喷喷香	喷喷香
喷香	喷香
蓬勃	蓬勃
蓬勃向上	蓬勃向上
蓬蓬勃勃	蓬蓬勃勃
蓬茸	蓬茸
披肝沥胆	披肝沥胆
披沥	披沥
芃芃	芃芃
皮实	皮实
偏偏	偏偏
偏要	偏要
飘洒	飘洒
品学兼优	品学兼优
平	平
平安无事	平安无事
平等	平等
平等地	平等地
平等互利	平等互利
平滑	平滑
平缓	平缓
平平安安	平平安安
平平静静	平平静静
平坦	平坦
平稳	平稳
平心静气	平心静气
平易	平易
平易近人	平易近人
平允	平允
平展	平展
平整	平整
评价颇高	评价颇高
屏气凝神	屏气凝神
屏声息气	屏声息气
屏息静气	屏息静气
泼悍	泼悍
颇为重要	颇为重要
破釜沉舟	破釜沉舟
朴	朴
朴厚	朴厚
朴茂	朴茂
朴实无华	朴实无华
朴素	朴素
朴直	朴直
朴质	朴质
朴拙	朴拙
其乐融融	其乐融融
其乐无穷	其乐无穷
其实	其实
奇货可居	奇货可居
奇妙	奇妙
奇巧	奇巧
齐	齐
齐备	齐备
齐楚	齐楚
齐全	齐全
齐刷刷	齐刷刷
齐整	齐整
旗帜鲜明	旗帜鲜明
起眼儿	起眼儿
器宇不凡	器宇不凡
器宇轩昂	器宇轩昂
气冲霄汉	气冲霄汉
气度不凡	气度不凡
气度恢宏	气度恢宏
气概不凡	气概不凡
气贯长虹	气贯长虹
气派	气派
气魄	气魄
气吞山河	气吞山河
气象万千	气象万千
气宇轩昂	气宇轩昂
恰	恰
恰当	恰当
恰到好处	恰到好处
恰如其分	恰如其分
千方百计	千方百计
千娇百媚	千娇百媚
千依百顺	千依百顺
千真万确	千真万确
千姿百态	千姿百态
谦	谦
谦卑	谦卑
谦诚	谦诚
谦恭	谦恭
谦和	谦和
谦顺	谦顺
谦虚	谦虚
谦虚谨慎	谦虚谨慎
谦逊	谦逊
前程似锦	前程似锦
前程万里	前程万里
前所未见	前所未见
前所未闻	前所未闻
前所未有	前所未有
前卫	前卫
前无古人	前无古人
潜心	潜心
浅近	浅近
浅显	浅显
浅易	浅易
强大	强大
强固	强固
强悍	强悍
强健	强健
强势	强势
强硬	强硬
强有力	强有力
强壮有力	强壮有力
抢眼	抢眼
悄	悄
悄没声	悄没声
悄悄	悄悄
悄然	悄然
悄声	悄声
巧夺天工	巧夺天工
巧妙	巧妙
俏	俏
俏丽	俏丽
俏美	俏美
俏皮	俏皮
切身	切身
切题	切题
亲切友好	亲切友好
亲善	亲善
亲昵	亲昵
勤	勤
勤奋	勤奋
勤恳	勤恳
勤快	勤快
勤劳	勤劳
勤勉	勤勉
勤勤恳恳	勤勤恳恳
沁人心脾	沁人心脾
沁入肺腑	沁入肺腑
轻薄透明	轻薄透明
轻车熟路	轻车熟路
轻而易举	轻而易举
轻健	轻健
轻捷	轻捷
轻快	轻快
轻灵	轻灵
轻悄悄	轻悄悄
轻巧	轻巧
轻轻地	轻轻地
轻轻松松	轻轻松松
轻手轻脚	轻手轻脚
轻悠悠	轻悠悠
倾国倾城	倾国倾城
倾情	倾情
倾心	倾心
清	清
清白	清白
清彻	清彻
清澈	清澈
清澈见底	清澈见底
清楚	清楚
清醇	清醇
清纯	清纯
清脆	清脆
清洁卫生	清洁卫生
清静	清静
清净	清净
清口	清口
清朗	清朗
清丽	清丽
清廉	清廉
清亮	清亮
清亮亮	清亮亮
清凌凌	清凌凌
清明	清明
清平	清平
清切	清切
清通	清通
清婉	清婉
清晰可辨	清晰可辨
清晰明了	清晰明了
清新淡雅	清新淡雅
清秀	清秀
清雅	清雅
清一色	清一色
清幽幽	清幽幽
清越	清越
清湛	清湛
清真	清真
清正	清正
清馨	清馨
情文并茂	情文并茂
情意恳挚	情意恳挚
情真意切	情真意切
秋毫无犯	秋毫无犯
求实	求实
求真务实	求真务实
求之不得	求之不得
曲线美	曲线美
趣	趣
趣味盎然	趣味盎然
权变	权变
权威性	权威性
权宜	权宜
全	全
全身心	全身心
全神贯注	全神贯注
全始全终	全始全终
全心全意	全心全意
全知全能	全知全能
拳拳	拳拳
确	确
确当	确当
确定不移	确定不移
确定性	确定性
确切	确切
确切无疑	确切无疑
确确实实	确确实实
确实	确实
确实可靠	确实可靠
确有其事	确有其事
确凿	确凿
确凿无疑	确凿无疑
群威群胆	群威群胆
群言堂	群言堂
饶富	饶富
饶爽	饶爽
饶沃	饶沃
饶有风趣	饶有风趣
饶有兴味	饶有兴味
饶有兴致	饶有兴致
饶有余韵	饶有余韵
扰攘	扰攘
绕圈子	绕圈子
热	热
热诚	热诚
热和	热和
热乎	热乎
热火	热火
热火朝天	热火朝天
热烈	热烈
热切	热切
热情洋溢	热情洋溢
热热闹闹	热热闹闹
热心	热心
热心肠	热心肠
仁	仁
仁爱	仁爱
仁慈	仁慈
仁厚	仁厚
仁义	仁义
仁至义尽	仁至义尽
人道	人道
人给家足	人给家足
人和	人和
人欢马叫	人欢马叫
人来人往	人来人往
人山人海	人山人海
人寿年丰	人寿年丰
韧	韧
任劳任怨	任劳任怨
任性	任性
认认真真	认认真真
荣	荣
荣幸	荣幸
融和	融和
融洽	融洽
容人	容人
容易	容易
柔	柔
柔和	柔和
柔曼	柔曼
柔美	柔美
柔媚	柔媚
柔韧	柔韧
柔顺	柔顺
柔婉	柔婉
柔中有刚	柔中有刚
肉墩墩	肉墩墩
儒雅	儒雅
如初	如初
如故	如故
如虎添翼	如虎添翼
如花似锦	如花似锦
如花似玉	如花似玉
如旧	如旧
如雷贯耳	如雷贯耳
如期	如期
如实	如实
如数家珍	如数家珍
如饮醍醐	如饮醍醐
如鱼得水	如鱼得水
入耳	入耳
入画	入画
入理	入理
入木三分	入木三分
入情入理	入情入理
入神	入神
入时	入时
入微	入微
入味	入味
入眼	入眼
软心肠	软心肠
瑞	瑞
锐	锐
锐利	锐利
锐敏	锐敏
锐意	锐意
润	润
洒脱	洒脱
三思而后行	三思而后行
三思而行	三思而行
三下五除二	三下五除二
嗓子好	嗓子好
森然	森然
森森	森森
山明水秀	山明水秀
山清水秀	山清水秀
山摇地动	山摇地动
闪闪	闪闪
擅场	擅场
善	善
善交际	善交际
善良	善良
善始善终	善始善终
善意	善意
赏罚分明	赏罚分明
赏罚严明	赏罚严明
赏心悦目	赏心悦目
上	上
上等	上等
上赶	上赶
上赶着	上赶着
上好	上好
上劲	上劲
上镜	上镜
上流	上流
上品	上品
上上	上上
上相	上相
上照	上照
捎带	捎带
韶	韶
韶秀	韶秀
少不得	少不得
设备齐全	设备齐全
伸缩	伸缩
身强力壮	身强力壮
身强体壮	身强体壮
身手不凡	身手不凡
身体结实	身体结实
身心健康	身心健康
深	深
深奥	深奥
深藏若虚	深藏若虚
深长	深长
深切	深切
深入浅出	深入浅出
深入人心	深入人心
深透	深透
深远	深远
深湛	深湛
深挚	深挚
深邃	深邃
神	神
神奥	神奥
神采飞扬	神采飞扬
神采焕发	神采焕发
神采奕奕	神采奕奕
神工鬼斧	神工鬼斧
神妙	神妙
神气	神气
神圣	神圣
神圣不可侵犯	神圣不可侵犯
神通广大	神通广大
神勇	神勇
审慎	审慎
慎	慎
慎重	慎重
声名大噪	声名大噪
声名大振	声名大振
声情并茂	声情并茂
声势浩大	声势浩大
生长完全	生长完全
生动	生动
生动活泼	生动活泼
生花妙笔	生花妙笔
生机盎然	生机盎然
生机勃勃	生机勃勃
生龙活虎	生龙活虎
生猛	生猛
生气勃勃	生气勃勃
生杀予夺	生杀予夺
生死	生死
生死不渝	生死不渝
生死攸关	生死攸关
生意盎然	生意盎然
升平	升平
省俭	省俭
省力	省力
省时	省时
省事	省事
省心	省心
盛	盛
盛大	盛大
胜	胜
圣	圣
圣洁	圣洁
圣礼	圣礼
圣明	圣明
十分重要	十分重要
十拿九稳	十拿九稳
十全	十全
十全十美	十全十美
石破天惊	石破天惊
拾金不昧	拾金不昧
时新	时新
时兴	时兴
时髦	时髦
实	实
实诚	实诚
实打实	实打实
实际上	实际上
实施得力	实施得力
实实惠惠	实实惠惠
实实在在	实实在在
实事求是	实事求是
实心	实心
实心实意	实心实意
实心眼儿	实心眼儿
实意	实意
实则	实则
实至名归	实至名归
实质上	实质上
实质性	实质性
识趣	识趣
史诗般	史诗般
史无前例	史无前例
使人愉快	使人愉快
使用方便	使用方便
始终不懈	始终不懈
始终不渝	始终不渝
始终如一	始终如一
世界级	世界级
事关重大	事关重大
事实胜于雄辩	事实胜于雄辩
是	是
是的	是的
适	适
适当	适当
适逢其会	适逢其会
适口	适口
适宜	适宜
适意	适意
手不释卷	手不释卷
手脚麻利	手脚麻利
手快	手快
手巧	手巧
手勤	手勤
手软	手软
手松	手松
首屈一指	首屈一指
首要	首要
守法	守法
守时	守时
守时间	守时间
受吃	受吃
受过良好训练	受过良好训练
受看	受看
受听	受听
殊	殊
舒	舒
舒畅	舒畅
舒快	舒快
舒舒服服	舒舒服服
舒爽	舒爽
舒松	舒松
舒坦	舒坦
舒心	舒心
淑	淑
熟	熟
熟练	熟练
熟巧	熟巧
熟识	熟识
熟透	熟透
属实	属实
树叶茂盛	树叶茂盛
数得上	数得上
数得着	数得着
数一数二	数一数二
帅	帅
双料	双料
双稳态	双稳态
爽	爽
爽口	爽口
爽快	爽快
爽朗	爽朗
爽利	爽利
爽目	爽目
爽气	爽气
爽心悦目	爽心悦目
爽直	爽直
水滴石穿	水滴石穿
水灵	水灵
水灵灵	水灵灵
水乳交融	水乳交融
水汪汪	水汪汪
水莹莹	水莹莹
水涔涔	水涔涔
顺	顺
顺当	顺当
顺耳	顺耳
顺口	顺口
顺理成章	顺理成章
顺势	顺势
顺手	顺手
顺顺当当	顺顺当当
顺眼	顺眼
说白了	说白了
说得通	说得通
说一不二	说一不二
硕学	硕学
烁	烁
烁亮	烁亮
斯斯文文	斯斯文文
思路清晰	思路清晰
丝毫不差	丝毫不差
死得其所	死得其所
死活	死活
死静	死静
四平八稳	四平八稳
似曾相识	似曾相识
松	松
松动	松动
松快	松快
素洁	素洁
素朴	素朴
素雅	素雅
速效	速效
肃静	肃静
肃穆	肃穆
肃然	肃然
随手	随手
随宜	随宜
随遇而安	随遇而安
绥	绥
缩手缩脚	缩手缩脚
塌实	塌实
踏踏实实	踏踏实实
台面上	台面上
泰	泰
泰然处之	泰然处之
泰然自若	泰然自若
太太平平	太太平平
谈吐不俗	谈吐不俗
谈言微中	谈言微中
坦	坦
坦白	坦白
坦诚	坦诚
坦诚相待	坦诚相待
坦诚相见	坦诚相见
坦荡	坦荡
坦荡荡	坦荡荡
坦率	坦率
坦率直言	坦率直言
坦实	坦实
坦坦荡荡	坦坦荡荡
坦直	坦直
探囊取物	探囊取物
堂而皇之	堂而皇之
堂皇	堂皇
堂堂	堂堂
堂堂正正	堂堂正正
糖味	糖味
掏心	掏心
陶	陶
特出	特出
特等	特等
特级	特级
特异	特异
剔透	剔透
体面	体面
体态轻盈	体态轻盈
体系化	体系化
惕	惕
天才	天才
天赐	天赐
天从人愿	天从人愿
天翻地覆	天翻地覆
天公地道	天公地道
天经地义	天经地义
天随人愿	天随人愿
天遂人愿	天遂人愿
天下为公	天下为公
天香国色	天香国色
天摇地动	天摇地动
天衣无缝	天衣无缝
天造地设	天造地设
天真烂漫	天真烂漫
天真无邪	天真无邪
天姿国色	天姿国色
天字第一号	天字第一号
甜	甜
甜蜜蜜	甜蜜蜜
甜丝丝	甜丝丝
甜滋滋	甜滋滋
恬	恬
恬静	恬静
恬适	恬适
挑战性	挑战性
贴边儿	贴边儿
贴切	贴切
贴题	贴题
铁案如山	铁案如山
铁打	铁打
铁定	铁定
铁骨铮铮	铁骨铮铮
铁面无私	铁面无私
铁心	铁心
铁杵磨成针	铁杵磨成针
铁铮铮	铁铮铮
停妥	停妥
亭亭玉立	亭亭玉立
亭匀	亭匀
挺括	挺括
挺秀	挺秀
通	通
通畅	通畅
通达	通达
通亮	通亮
通明	通明
通明透亮	通明透亮
通情达理	通情达理
通权达变	通权达变
通顺	通顺
通俗	通俗
通俗易懂	通俗易懂
通天	通天
通透	通透
同等重要	同等重要
童颜鹤发	童颜鹤发
痛快	痛快
痛痛快快	痛痛快快
投缘	投缘
头	头
头等	头等
头号	头号
头面	头面
头脑清醒	头脑清醒
头头是道	头头是道
透辟	透辟
透彻	透彻
透亮	透亮
突出	突出
突破性	突破性
团结	团结
脱俗	脱俗
妥	妥
妥当	妥当
妥切	妥切
妥善	妥善
妥贴	妥贴
瓦亮	瓦亮
外向	外向
顽强	顽强
顽石点头	顽石点头
完	完
完备	完备
完好	完好
完好如初	完好如初
完好如新	完好如新
完好无损	完好无损
完美无疵	完美无疵
完美无缺	完美无缺
完美无瑕	完美无瑕
完善	完善
宛转	宛转
婉	婉
婉丽	婉丽
婉娩	婉娩
婉顺	婉顺
婉言	婉言
婉约	婉约
婉转	婉转
万变不离其宗	万变不离其宗
万不得已	万不得已
万夫不当	万夫不当
万夫莫当	万夫莫当
万古长青	万古长青
万马奔腾	万马奔腾
万全	万全
万人空巷	万人空巷
万无一失	万无一失
万众瞩目	万众瞩目
万籁俱寂	万籁俱寂
网开一面	网开一面
旺	旺
旺盛	旺盛
忘我	忘我
威风	威风
威风凛凛	威风凛凛
威严	威严
微言大义	微言大义
唯命是从	唯命是从
唯命是听	唯命是听
唯唯诺诺	唯唯诺诺
惟命是从	惟命是从
惟命是听	惟命是听
为人宽厚	为人宽厚
为人正直	为人正直
为宜	为宜
委婉	委婉
伟	伟
伟岸	伟岸
蔚	蔚
味道好	味道好
味道鲜	味道鲜
温存	温存
温厚	温厚
温静	温静
温良	温良
温情脉脉	温情脉脉
温润	温润
温顺	温顺
温文尔雅	温文尔雅
温驯	温驯
温煦	温煦
文不加点	文不加点
文从字顺	文从字顺
文静	文静
文明	文明
文文静静	文文静静
文武兼备	文武兼备
文武全才	文武全才
文武双全	文武双全
文雅	文雅
文质彬彬	文质彬彬
文绉绉	文绉绉
闻达	闻达
闻过则喜	闻过则喜
闻名	闻名
稳	稳
稳步	稳步
稳当	稳当
稳固	稳固
稳健	稳健
稳如泰山	稳如泰山
稳态	稳态
稳妥	稳妥
稳扎稳打	稳扎稳打
沃	沃
无比幸福	无比幸福
无变化	无变化
无偿	无偿
无疵	无疵
无错误	无错误
无毒	无毒
无辜	无辜
无害	无害
无华	无华
无价	无价
无拘束	无拘束
无拘无束	无拘无束
无可非议	无可非议
无可厚非	无可厚非
无可争议	无可争议
无可置疑	无可置疑
无可訾议	无可訾议
无牵无挂	无牵无挂
无人不晓	无人不晓
无容置疑	无容置疑
无上	无上
无上光荣	无上光荣
无奢望	无奢望
无私	无私
无私无畏	无私无畏
无损	无损
无所不可	无所不可
无所不能	无所不能
无所不知	无所不知
无所顾忌	无所顾忌
无所畏惧	无所畏惧
无微不至	无微不至
无畏	无畏
无污染	无污染
无误	无误
无先例	无先例
无懈可击	无懈可击
无忧无虑	无忧无虑
无罪	无罪
无瑕疵	无瑕疵
无恙	无恙
武	武
五彩纷呈	五彩纷呈
五大三粗	五大三粗
五谷丰登	五谷丰登
物阜民丰	物阜民丰
物理	物理
熙	熙
熙和	熙和
熙来攘往	熙来攘往
熙攘	熙攘
熙熙攘攘	熙熙攘攘
晰	晰
吸引人眼球	吸引人眼球
悉心	悉心
犀利	犀利
洗炼	洗炼
洗练	洗练
戏剧化	戏剧化
戏剧性	戏剧性
细颗粒度	细颗粒度
细密	细密
细巧	细巧
细润	细润
细细	细细
细针密缕	细针密缕
侠义	侠义
下饭	下饭
下酒	下酒
先公后私	先公后私
先进	先进
先决	先决
先人后己	先人后己
鲜	鲜
鲜活	鲜活
鲜亮	鲜亮
鲜美	鲜美
鲜明	鲜明
纤尘不染	纤尘不染
纤巧	纤巧
贤	贤
贤达	贤达
贤慧	贤慧
贤惠	贤惠
贤明	贤明
闲雅	闲雅
显	显
显达	显达
显而易见	显而易见
显贵	显贵
显赫	显赫
显豁	显豁
显见	显见
显明	显明
显目	显目
显然	显然
显性	显性
显要	显要
显耀	显耀
险固	险固
相安	相安
相安无事	相安无事
相当重要	相当重要
香	香
香醇	香醇
香纯	香纯
香喷喷	香喷喷
香甜	香甜
香甜可口	香甜可口
香馥馥	香馥馥
翔实	翔实
祥	祥
祥和	祥和
详	详
详备	详备
详尽	详尽
详密	详密
详明	详明
详实	详实
详悉	详悉
详详细细	详详细细
响当当	响当当
像话	像话
像样	像样
像样子	像样子
象话	象话
萧洒	萧洒
消遣	消遣
消停	消停
消消停停	消消停停
晓事	晓事
小康	小康
小面额	小面额
小巧玲珑	小巧玲珑
小心	小心
小心谨慎	小心谨慎
小心翼翼	小心翼翼
小有名气	小有名气
协调一致	协调一致
谐	谐
谐调	谐调
谐和	谐和
谐趣横生	谐趣横生
写意	写意
欣然	欣然
欣欣然	欣欣然
欣欣向荣	欣欣向荣
辛勤	辛勤
新	新
新潮	新潮
新奇	新奇
新异	新异
心肠软	心肠软
心慈	心慈
心慈面软	心慈面软
心慈手软	心慈手软
心地纯良	心地纯良
心地善良	心地善良
心口如一	心口如一
心宽	心宽
心灵美	心灵美
心灵手巧	心灵手巧
心明眼亮	心明眼亮
心软	心软
心细	心细
心胸开阔	心胸开阔
心直口快	心直口快
信得过	信得过
信赏必罚	信赏必罚
信实	信实
信息丰富	信息丰富
星级	星级
惺	惺
惺惺	惺惺
兴趣盎然	兴趣盎然
兴盛	兴盛
兴旺	兴旺
形象地	形象地
形象化	形象化
行	行
行得通	行得通
行时	行时
行云流水	行云流水
行之有效	行之有效
醒豁	醒豁
醒目	醒目
醒眼	醒眼
性格外向	性格外向
性命交关	性命交关
性命攸关	性命攸关
性情温良	性情温良
胸怀坦白	胸怀坦白
胸怀坦荡	胸怀坦荡
汹汹	汹汹
汹涌	汹涌
汹涌澎湃	汹涌澎湃
雄	雄
雄健	雄健
雄峻	雄峻
雄伟	雄伟
雄心勃勃	雄心勃勃
雄壮	雄壮
雄姿英发	雄姿英发
雄赳赳	雄赳赳
熊腰虎背	熊腰虎背
修明	修明
秀	秀
秀拔	秀拔
秀慧	秀慧
秀俊	秀俊
秀美	秀美
秀媚	秀媚
秀气	秀气
秀巧	秀巧
秀润	秀润
秀色	秀色
秀色可餐	秀色可餐
秀挺	秀挺
秀外慧中	秀外慧中
秀外惠中	秀外惠中
秀雅	秀雅
秀逸	秀逸
秀异	秀异
虚怀若谷	虚怀若谷
虚己	虚己
虚心	虚心
轩昂	轩昂
喧闹	喧闹
旋律优美	旋律优美
玄奥	玄奥
玄而又玄	玄而又玄
玄秘	玄秘
玄妙	玄妙
玄远	玄远
玄之又玄	玄之又玄
眩目	眩目
绚	绚
绚烂	绚烂
绚丽多彩	绚丽多彩
绚丽多姿	绚丽多姿
绚丽夺目	绚丽夺目
学而不厌	学而不厌
学富五车	学富五车
学力宏赡	学力宏赡
学识渊博	学识渊博
学有专长	学有专长
雪亮	雪亮
血气方刚	血气方刚
驯	驯
驯服	驯服
驯良	驯良
驯善	驯善
驯顺	驯顺
训练良好	训练良好
训练有素	训练有素
逊	逊
鸦雀无声	鸦雀无声
雅	雅
雅观	雅观
雅静	雅静
雅俗共赏	雅俗共赏
雅正	雅正
雅致	雅致
严谨	严谨
严整	严整
严正	严正
言必有中	言必有中
言简意赅	言简意赅
言语流利	言语流利
言之成理	言之成理
言之有理	言之有理
眼光锐利	眼光锐利
眼光远大	眼光远大
眼花缭乱	眼花缭乱
眼疾手快	眼疾手快
眼尖	眼尖
眼明手快	眼明手快
眼熟	眼熟
艳	艳
艳丽	艳丽
艳冶	艳冶
洋洋大观	洋洋大观
阳	阳
阳刚	阳刚
阳性	阳性
养尊处优	养尊处优
妖媚	妖媚
妖艳	妖艳
妖冶	妖冶
妖娆	妖娆
药到病除	药到病除
要	要
要害	要害
要强	要强
要死要活	要死要活
要言不烦	要言不烦
耀	耀
耀眼	耀眼
野心勃勃	野心勃勃
冶容	冶容
冶艳	冶艳
夜不闭户	夜不闭户
一板正经	一板正经
一本正经	一本正经
一笔不苟	一笔不苟
一笔一划	一笔一划
一表非凡	一表非凡
一步一个脚印儿	一步一个脚印儿
一尘不染	一尘不染
一等	一等
一干二净	一干二净
一个心眼儿	一个心眼儿
一贯	一贯
一呼百诺	一呼百诺
一呼百应	一呼百应
一刻千金	一刻千金
一口	一口
一门心思	一门心思
一目了然	一目了然
一清二白	一清二白
一清二楚	一清二楚
一如既往	一如既往
一若以往	一若以往
一身是胆	一身是胆
一身正气	一身正气
一视同仁	一视同仁
一丝不差	一丝不差
一丝不苟	一丝不苟
一体化	一体化
一团和气	一团和气
一碗水端平	一碗水端平
一五一十	一五一十
一心	一心
一心一德	一心一德
一心一意	一心一意
一叶知秋	一叶知秋
一语双关	一语双关
一元化	一元化
一专多能	一专多能
一字不差地	一字不差地
依旧	依旧
衣冠楚楚	衣冠楚楚
夷	夷
仪表堂堂	仪表堂堂
仪态万方	仪态万方
宜	宜
已知	已知
以德报怨	以德报怨
以一当十	以一当十
易	易
易如反掌	易如反掌
逸乐	逸乐
亦然	亦然
意味深长	意味深长
意在言外	意在言外
毅	毅
毅然	毅然
毅然决然	毅然决然
义	义
义务	义务
异彩纷呈	异彩纷呈
茵茵	茵茵
因材施教	因材施教
因地制宜	因地制宜
因陋就简	因陋就简
因时制宜	因时制宜
殷富	殷富
殷勤	殷勤
殷实	殷实
殷殷	殷殷
音调优美	音调优美
阴翳	阴翳
引人入胜	引人入胜
引人深思	引人深思
引人瞩目	引人瞩目
引人注目	引人注目
引人注意	引人注意
英俊	英俊
英烈	英烈
英明	英明
英武	英武
英勇	英勇
英姿飒爽	英姿飒爽
应有	应有
莹	莹
莹白	莹白
莹莹	莹莹
荧	荧
荧荧	荧荧
迎刃而解	迎刃而解
盈盈	盈盈
颖	颖
颖慧	颖慧
颖悟	颖悟
硬棒	硬棒
硬朗	硬朗
硬实	硬实
雍和	雍和
雍容	雍容
雍容华贵	雍容华贵
踊跃	踊跃
勇	勇
勇悍	勇悍
勇猛	勇猛
勇武	勇武
用得着	用得着
用功	用功
用心	用心
幽寂	幽寂
幽静	幽静
幽丽	幽丽
幽美	幽美
幽默滑稽	幽默滑稽
幽凄	幽凄
幽婉	幽婉
幽闲	幽闲
幽娴	幽娴
优	优
优等	优等
优厚	优厚
优良	优良
优美	优美
优美动听	优美动听
优胜	优胜
优雅	优雅
优异	优异
优裕	优裕
优越	优越
优渥	优渥
悠扬	悠扬
尤异	尤异
由衷	由衷
油光光	油光光
油光水滑	油光水滑
油光锃亮	油光锃亮
油亮	油亮
游刃有余	游刃有余
有案可稽	有案可稽
有板有眼	有板有眼
有保留地	有保留地
有鼻子有眼	有鼻子有眼
有鼻子有眼儿	有鼻子有眼儿
有才干	有才干
有财产	有财产
有朝气	有朝气
有出息	有出息
有胆量	有胆量
有的放矢	有的放矢
有地位	有地位
有方	有方
有福	有福
有福气	有福气
有个性	有个性
有根有据	有根有据
有功	有功
有贡献	有贡献
有涵养	有涵养
有恒	有恒
有纪律	有纪律
有价值	有价值
有见地	有见地
有见识	有见识
有教养	有教养
有教益	有教益
有节制	有节制
有据	有据
有口无心	有口无心
有棱角	有棱角
有理	有理
有理由	有理由
有理有据	有理有据
有礼	有礼
有礼貌	有礼貌
有利	有利
有良心	有良心
有两手	有两手
有两下子	有两下子
有眉目	有眉目
有门	有门
有门儿	有门儿
有名气	有名气
有目共睹	有目共睹
有能力	有能力
有派	有派
有盼	有盼
有盼儿	有盼儿
有品味	有品味
有求必应	有求必应
有韧劲	有韧劲
有伸缩性	有伸缩性
有声有色	有声有色
有识	有识
有始有终	有始有终
有所作为	有所作为
有条不紊	有条不紊
有条理	有条理
有条有理	有条有理
有同情心	有同情心
有头脑	有头脑
有头有脸	有头有脸
有头有尾	有头有尾
有望	有望
有威信	有威信
有为	有为
有文化	有文化
有文章	有文章
有戏	有戏
有心眼	有心眼
有心眼儿	有心眼儿
有序	有序
有学问	有学问
有血气	有血气
有血有肉	有血有肉
有眼光	有眼光
有眼力	有眼力
有一手	有一手
有意义	有意义
有勇气	有勇气
有智慧	有智慧
有种	有种
有滋味	有滋味
有滋有味	有滋有味
有嘴无心	有嘴无心
友	友
友爱	友爱
友好	友好
友善	友善
又红又专	又红又专
愚公移山	愚公移山
余裕	余裕
语重心长	语重心长
玉	玉
玉洁冰清	玉洁冰清
玉立	玉立
郁郁	郁郁
郁郁苍苍	郁郁苍苍
郁郁葱葱	郁郁葱葱
寓意深长	寓意深长
寓意深刻	寓意深刻
渊博	渊博
渊深	渊深
原封	原封
原封不动	原封不动
圆浑	圆浑
圆活	圆活
圆柔	圆柔
圆润	圆润
圆熟	圆熟
圆通	圆通
远大	远大
约	约
悦耳	悦耳
悦目	悦目
匀	匀
匀称	匀称
匀和	匀和
匀乎	匀乎
匀净	匀净
匀溜	匀溜
匀实	匀实
匀整	匀整
允当	允当
在理	在理
在情理之中	在情理之中
在行	在行
凿	凿
凿凿	凿凿
曾经沧海	曾经沧海
扎实	扎实
扎眼	扎眼
扎扎实实	扎扎实实
崭	崭
崭新	崭新
占理	占理
站得高，看得远	站得高，看得远
站得住	站得住
站得住脚	站得住脚
湛	湛
湛深	湛深
彰	彰
彰明较著	彰明较著
招笑儿	招笑儿
昭	昭
昭然	昭然
昭然若揭	昭然若揭
昭彰	昭彰
昭著	昭著
照旧	照旧
照理	照理
照实	照实
照样	照样
照章	照章
照直	照直
哲	哲
珍	珍
珍贵	珍贵
珍奇	珍奇
珍稀	珍稀
珍异	珍异
真	真
真格的	真格的
真率	真率
真切	真切
真确	真确
真实可信	真实可信
真心诚意	真心诚意
真心实意	真心实意
真心真意	真心真意
真性	真性
真真	真真
真真切切	真真切切
真真实实	真真实实
真挚	真挚
贞	贞
震古烁今	震古烁今
震撼人心	震撼人心
震天动地	震天动地
振奋人心	振奋人心
争相	争相
整	整
整洁	整洁
整齐	整齐
整齐划一	整齐划一
整整齐齐	整整齐齐
整饬	整饬
正	正
正常	正常
正大光明	正大光明
正当	正当
正当年	正当年
正点	正点
正而不谲	正而不谲
正经八百	正经八百
正牌	正牌
正派	正派
正统	正统
正义	正义
郑重	郑重
郑重其事	郑重其事
枝繁叶茂	枝繁叶茂
支柱性	支柱性
知情达理	知情达理
知趣	知趣
知书达理	知书达理
知书识礼	知书识礼
直	直
直肠子	直肠子
直截	直截
直截了当	直截了当
直捷	直捷
直来直去	直来直去
直率	直率
直爽	直爽
直心眼	直心眼
直心眼儿	直心眼儿
直性	直性
直性子	直性子
执著	执著
执着	执着
值得崇拜	值得崇拜
值得纪念	值得纪念
值得羡慕	值得羡慕
值钱	值钱
志在千里	志在千里
挚	挚
挚诚	挚诚
挚切	挚切
至诚	至诚
至高无上	至高无上
至关紧要	至关紧要
至关重大	至关重大
至关重要	至关重要
至上	至上
至深	至深
至尊	至尊
至尊至贵	至尊至贵
致密	致密
智	智
智慧型	智慧型
智能型	智能型
智勇双全	智勇双全
秩然不紊	秩然不紊
秩序井然	秩序井然
稚弱	稚弱
质朴	质朴
质朴无华	质朴无华
质优	质优
炙手可热	炙手可热
中	中
中坚	中坚
中看	中看
中肯	中肯
中听	中听
中心	中心
中用	中用
中允	中允
中正	中正
忠	忠
忠忱	忠忱
忠诚	忠诚
忠耿	忠耿
忠厚	忠厚
忠良	忠良
忠顺	忠顺
忠心赤胆	忠心赤胆
忠心耿耿	忠心耿耿
忠信	忠信
忠义	忠义
忠贞	忠贞
忠贞不贰	忠贞不贰
忠贞不屈	忠贞不屈
忠贞不渝	忠贞不渝
忠直	忠直
忠鲠	忠鲠
衷心	衷心
重大	重大
重点	重点
众口一词	众口一词
众目昭彰	众目昭彰
众目睽睽	众目睽睽
众所周知	众所周知
周密	周密
周详	周详
周至	周至
珠圆玉润	珠圆玉润
主导	主导
主要	主要
著	著
著称	著称
专心	专心
专心致志	专心致志
专一	专一
专挚	专挚
专注	专注
庄严	庄严
庄重	庄重
装备完善	装备完善
壮	壮
壮观	壮观
壮健	壮健
壮阔	壮阔
壮丽	壮丽
壮烈	壮烈
壮美	壮美
壮实	壮实
状况良好	状况良好
谆	谆
谆谆	谆谆
准	准
准点	准点
准期	准期
准确	准确
准确无误	准确无误
准时	准时
卓	卓
卓尔不群	卓尔不群
卓然	卓然
卓越超群	卓越超群
卓著	卓著
卓荦	卓荦
卓跞	卓跞
桌面儿上	桌面儿上
茁	茁
茁壮	茁壮
着边	着边
着边儿	着边儿
灼	灼
灼亮	灼亮
灼然	灼然
灼然可见	灼然可见
灼然无疑	灼然无疑
灼灼	灼灼
资深	资深
孜孜	孜孜
孜孜不倦	孜孜不倦
仔仔细细	仔仔细细
自卑	自卑
自不待言	自不待言
自觉自愿	自觉自愿
自来熟	自来熟
自明	自明
自由	自由
自由主义	自由主义
自由自在	自由自在
自愿	自愿
自尊	自尊
足色	足色
足月	足月
足智多谋	足智多谋
嘴紧	嘴紧
嘴快	嘴快
嘴稳	嘴稳
最高	最高
最高级	最高级
最理想	最理想
最著名	最著名
尊	尊
尊贵	尊贵
尊敬	尊敬
做得好	做得好
作为消遣	作为消遣
作兴	作兴
丕	丕
亘古未有	亘古未有
厮熟	厮熟
剀	剀
剡	剡
仡	仡
仞	仞
佶	佶
侃	侃
佼	佼
俨	俨
俨然	俨然
俅	俅
倩	倩
俳谐	俳谐
倬	倬
倜傥	倜傥
倜傥不群	倜傥不群
倜傥不羁	倜傥不羁
僖	僖
裒	裒
诙谐	诙谐
谙练	谙练
谠	谠
谧	谧
谧静	谧静
劢	劢
劬	劬
劭	劭
哿	哿
勐	勐
矍铄	矍铄
懿	懿
芊	芊
芊眠	芊眠
芊绵	芊绵
芊芊	芊芊
芾	芾
茏	茏
茏葱	茏葱
苒	苒
茌	茌
荟	荟
荦	荦
荦荦	荦荦
荦荦大者	荦荦大者
荩	荩
莺声燕语	莺声燕语
菁	菁
菁菁	菁菁
萋	萋
萋萋	萋萋
蓁	蓁
蓊	蓊
蓊郁	蓊郁
蕃	蕃
蕃茂	蕃茂
蕻	蕻
奕	奕
奘	奘
挢	挢
掬诚	掬诚
叱咤风云	叱咤风云
呱呱叫	呱呱叫
哏	哏
噱头	噱头
岑寂	岑寂
嶷	嶷
徼幸	徼幸
狷介	狷介
猗	猗
馐	馐
怡	怡
怡和	怡和
怡然	怡然
恺	恺
恪	恪
悃	悃
愣是	愣是
愣要	愣要
闳	闳
阒	阒
阒寂	阒寂
阒然	阒然
阗	阗
泱泱	泱泱
泠然	泠然
泠泠	泠泠
泠泠作响	泠泠作响
洌	洌
浃	浃
洵	洵
浏	浏
滟	滟
滢	滢
潇	潇
潇洒	潇洒
澹	澹
澹泊	澹泊
灏	灏
宓	宓
謇	謇
逍遥	逍遥
逍遥自在	逍遥自在
遐迩闻名	遐迩闻名
邃	邃
妍	妍
妍丽	妍丽
妩	妩
妩媚	妩媚
姝	姝
娈	娈
姣	姣
姣好	姣好
姣美	姣美
姹	姹
娉	娉
娉娉袅袅	娉娉袅袅
娉婷	娉婷
娴	娴
娴静	娴静
娴淑	娴淑
娴熟	娴熟
娴雅	娴雅
娓娓	娓娓
娓娓动听	娓娓动听
婀娜	婀娜
婀娜多姿	婀娜多姿
婵蝉	婵蝉
婵娟	婵娟
婵媛	婵媛
婷	婷
婷婷	婷婷
婷婷袅袅	婷婷袅袅
嫣	嫣
嫣然	嫣然
孳	孳
骁	骁
骁悍	骁悍
骁勇	骁勇
骠	骠
骠勇	骠勇
绮	绮
绮丽	绮丽
缜	缜
缜密	缜密
缥	缥
玮	玮
琦	琦
瑕不掩瑜	瑕不掩瑜
璀璨	璀璨
璀璨夺目	璀璨夺目
璞玉浑金	璞玉浑金
璨然	璨然
韪	韪
枭	枭
栩栩	栩栩
栩栩如活	栩栩如活
栩栩如生	栩栩如生
戛戛	戛戛
臧	臧
杲	杲
杲杲	杲杲
炅	炅
昶	昶
晟	晟
晔	晔
赅博	赅博
肜	肜
肫	肫
脍炙人口	脍炙人口
腴	腴
膂力过人	膂力过人
飒爽	飒爽
飒爽英姿	飒爽英姿
斐	斐
斐然	斐然
旖旎	旖旎
炜	炜
炫目	炫目
烨	烨
煊	煊
煊赫	煊赫
熠	熠
熠耀	熠耀
熠熠	熠熠
熠熠生辉	熠熠生辉
祯	祯
祺	祺
悫	悫
懋	懋
戆直	戆直
眇	眇
睿	睿
睿哲	睿哲
睿智	睿智
钐	钐
铮	铮
铮亮	铮亮
铮铮	铮铮
铮铮铁骨	铮铮铁骨
铿锵	铿锵
锃	锃
锃光瓦亮	锃光瓦亮
锃亮	锃亮
锖	锖
锬	锬
锲而不舍	锲而不舍
馥郁	馥郁
馥馥	馥馥
穰穰	穰穰
皎	皎
皎白	皎白
皎洁	皎洁
皎皎	皎皎
皓	皓
皓月当空	皓月当空
鸾凤和鸣	鸾凤和鸣
窈窕	窈窕
虔	虔
虔诚	虔诚
虔敬	虔敬
虔心	虔心
笃诚	笃诚
笃厚	笃厚
笃实	笃实
笃学	笃学
袅	袅
袅娜	袅娜
袅袅婷婷	袅袅婷婷
粲	粲
粲然	粲然
粼	粼
粼粼	粼粼
艮	艮
翕	翕
翕然	翕然
翩然	翩然
翩若惊鸿	翩若惊鸿
翩翩	翩翩
翩跹	翩跹
赳赳	赳赳
醍醐灌顶	醍醐灌顶
跹	跹
觥筹交错	觥筹交错
靓	靓
霁月光风	霁月光风
隽永	隽永
鑫	鑫
鲠直	鲠直
髀肉复生	髀肉复生
魅人	魅人
媢	媢
媢嫉	媢嫉
忺	忺
爱不忍释	爱不忍释
爱不释手	爱不释手
爱宠	爱宠
爱戴	爱戴
爱抚	爱抚
爱护	爱护
爱怜	爱怜
爱恋	爱恋
爱慕	爱慕
爱屋及乌	爱屋及乌
爱惜	爱惜
昂扬	昂扬
巴	巴
巴不得	巴不得
巴望	巴望
摆好	摆好
拜	拜
拜拜	拜拜
拜服	拜服
拜贺	拜贺
拜谒	拜谒
褒	褒
褒奖	褒奖
褒扬	褒扬
睎	睎
表扬	表扬
表彰	表彰
并重	并重
补台	补台
不看僧面看佛面	不看僧面看佛面
不胜欣忭	不胜欣忭
不惜	不惜
不厌	不厌
睬	睬
采纳	采纳
参拜	参拜
参谒	参谒
侧重	侧重
馋	馋
畅快	畅快
唱喏	唱喏
倡	倡
朝拜	朝拜
朝思暮想	朝思暮想
撑台面	撑台面
撑腰	撑腰
称	称
称道	称道
称快	称快
称赏	称赏
称颂	称颂
称叹	称叹
称羡	称羡
称谢	称谢
称心	称心
称心如意	称心如意
称心如愿	称心如愿
称许	称许
称誉	称誉
称愿	称愿
称赞	称赞
承	承
承蒙	承蒙
承情	承情
承望	承望
承应	承应
骋怀	骋怀
吃醋	吃醋
痴恋	痴恋
痴迷	痴迷
痴情	痴情
痴心不改	痴心不改
痴心妄想	痴心妄想
驰念	驰念
驰思	驰思
崇拜	崇拜
崇敬	崇敬
崇尚	崇尚
崇仰	崇仰
宠	宠
宠爱	宠爱
宠幸	宠幸
酬谢	酬谢
踌躇满志	踌躇满志
出迎	出迎
垂爱	垂爱
垂念	垂念
垂青	垂青
垂涎	垂涎
垂涎三尺	垂涎三尺
垂涎欲滴	垂涎欲滴
春风得意	春风得意
春风满面	春风满面
醋意大发	醋意大发
措意	措意
答礼	答礼
答谢	答谢
打千	打千
大快人心	大快人心
大喜过望	大喜过望
戴	戴
胆敢	胆敢
弹冠相庆	弹冠相庆
当真	当真
当之无愧	当之无愧
倒向	倒向
道贺	道贺
道谢	道谢
得意	得意
得意忘形	得意忘形
点头	点头
点头称是	点头称是
点头哈腰	点头哈腰
电贺	电贺
奠祭	奠祭
吊祭	吊祭
盯紧	盯紧
盯住	盯住
顶礼	顶礼
顶礼膜拜	顶礼膜拜
抖	抖
睹物思人	睹物思人
妒	妒
妒恨	妒恨
妒火中烧	妒火中烧
妒嫉	妒嫉
妒忌	妒忌
妒羡	妒羡
多留个心眼儿	多留个心眼儿
堕入爱河	堕入爱河
堕入情网	堕入情网
额手称庆	额手称庆
反哺	反哺
放胆	放胆
放在心上	放在心上
费心	费心
封禅	封禅
疯魔	疯魔
奉	奉
奉若神明	奉若神明
奉迎	奉迎
俯允	俯允
甘心	甘心
甘心情愿	甘心情愿
甘愿	甘愿
感	感
感恩戴德	感恩戴德
感激	感激
感激不尽	感激不尽
感激涕零	感激涕零
感同身受	感同身受
高看	高看
高山仰止	高山仰止
歌颂	歌颂
给脸	给脸
给面子	给面子
恭而敬之	恭而敬之
恭贺	恭贺
恭维	恭维
恭祝	恭祝
供奉	供奉
公祭	公祭
拱手	拱手
顾	顾
顾及	顾及
顾盼自雄	顾盼自雄
顾全	顾全
顾惜	顾惜
关爱	关爱
关怀	关怀
关怀备至	关怀备至
关切	关切
关照	关照
管	管
贯注	贯注
鬼迷心窍	鬼迷心窍
跪拜	跪拜
跪叩	跪叩
过奖	过奖
过问	过问
过誉	过誉
哈	哈
酣畅	酣畅
豪情满怀	豪情满怀
好情	好情
喝彩	喝彩
合掌	合掌
贺	贺
狠抓	狠抓
恨不得	恨不得
恨不能	恨不能
横心	横心
厚望	厚望
怀	怀
怀恋	怀恋
怀想	怀想
欢	欢
欢畅	欢畅
欢欢喜喜	欢欢喜喜
欢快	欢快
欢闹	欢闹
欢声雷动	欢声雷动
欢腾	欢腾
欢天喜地	欢天喜地
欢慰	欢慰
欢喜	欢喜
欢欣	欢欣
欢欣鼓舞	欢欣鼓舞
欢愉	欢愉
欢娱	欢娱
欢悦	欢悦
欢忭	欢忭
还礼	还礼
回敬	回敬
回礼	回礼
魂牵梦系	魂牵梦系
魂牵梦萦	魂牵梦萦
豁朗	豁朗
稽首	稽首
极热心	极热心
集注	集注
嫉	嫉
嫉妒	嫉妒
冀	冀
冀求	冀求
冀望	冀望
祭	祭
祭拜	祭拜
祭奠	祭奠
祭扫	祭扫
祭祀	祭祀
记挂	记挂
忌妒	忌妒
嘉奖	嘉奖
嘉许	嘉许
夹道欢迎	夹道欢迎
兼顾	兼顾
检点	检点
见爱	见爱
见义勇为	见义勇为
奖	奖
奖励	奖励
奖赏	奖赏
奖掖	奖掖
讲求	讲求
交口称誉	交口称誉
交口称赞	交口称赞
叫好	叫好
叫绝	叫绝
皆大欢喜	皆大欢喜
尽孝	尽孝
尽忠	尽忠
景仰	景仰
敬爱	敬爱
敬奉	敬奉
敬服	敬服
敬贺	敬贺
敬礼	敬礼
敬慕	敬慕
敬佩	敬佩
敬若神明	敬若神明
敬畏	敬畏
敬仰	敬仰
敬重	敬重
敬祝	敬祝
竟敢	竟敢
鞠躬	鞠躬
聚焦	聚焦
聚精会神	聚精会神
眷爱	眷爱
眷恋	眷恋
眷念	眷念
开绿灯	开绿灯
看车	看车
看得起	看得起
看得上	看得上
看得上眼	看得上眼
看上	看上
看上眼	看上眼
看在	看在
看中	看中
看重	看重
磕头	磕头
渴慕	渴慕
渴念	渴念
渴盼	渴盼
渴求	渴求
渴望	渴望
渴想	渴想
肯	肯
肯于	肯于
口角春风	口角春风
酷爱	酷爱
酷好	酷好
夸	夸
夸奖	夸奖
夸赞	夸赞
快活	快活
快慰	快慰
快意	快意
宽畅	宽畅
狂喜	狂喜
狂想	狂想
来神	来神
乐	乐
乐不可支	乐不可支
乐颠颠	乐颠颠
乐呵呵	乐呵呵
乐乐呵呵	乐乐呵呵
乐陶陶	乐陶陶
乐意	乐意
乐悠悠	乐悠悠
乐于	乐于
乐滋滋	乐滋滋
理直气壮	理直气壮
礼赞	礼赞
立项	立项
力主	力主
怜爱	怜爱
恋	恋
恋恋不舍	恋恋不舍
领情	领情
留个心眼儿	留个心眼儿
留神	留神
论功行赏	论功行赏
买账	买账
满怀豪情	满怀豪情
满怀激情	满怀激情
满面春风	满面春风
满心欢喜	满心欢喜
眉飞色舞	眉飞色舞
美言	美言
美滋滋	美滋滋
梦魂萦绕	梦魂萦绕
梦寐以求	梦寐以求
迷	迷
迷恋	迷恋
迷上	迷上
面有喜色	面有喜色
鸣谢	鸣谢
谬奖	谬奖
膜拜	膜拜
默认	默认
默许	默许
慕	慕
慕名	慕名
溺爱	溺爱
念	念
拍案叫绝	拍案叫绝
拍手称快	拍手称快
拍手叫好	拍手叫好
盼	盼
盼念	盼念
盼望	盼望
佩	佩
捧场	捧场
批准	批准
偏爱	偏爱
偏宠	偏宠
偏好	偏好
偏重	偏重
飘飘然	飘飘然
飘飘欲仙	飘飘欲仙
迫切需要	迫切需要
普天同庆	普天同庆
期	期
期待	期待
期盼	期盼
祈盼	祈盼
起敬	起敬
企	企
企慕	企慕
企盼	企盼
企望	企望
器重	器重
牵肠挂肚	牵肠挂肚
牵挂	牵挂
千恩万谢	千恩万谢
敲边鼓	敲边鼓
瞧得起	瞧得起
瞧得上眼	瞧得上眼
翘盼	翘盼
翘企	翘企
翘望	翘望
钦	钦
钦佩	钦佩
亲热	亲热
亲热亲热	亲热亲热
倾慕	倾慕
倾向	倾向
情有独钟	情有独钟
情愿	情愿
庆	庆
庆贺	庆贺
庆祝	庆祝
圈定	圈定
饶有兴趣	饶有兴趣
人心大快	人心大快
认	认
认可	认可
认了	认了
认命	认命
日有所思	日有所思
容	容
容许	容许
如痴如狂	如痴如狂
如痴如醉	如痴如醉
如获至宝	如获至宝
如意	如意
如愿以偿	如愿以偿
如醉如痴	如醉如痴
入迷	入迷
入魔	入魔
赏	赏
赏识	赏识
赏赉	赏赉
尚	尚
烧高香	烧高香
奢望	奢望
申谢	申谢
伸张	伸张
神魂颠倒	神魂颠倒
甚感欢慰	甚感欢慰
盛赞	盛赞
施礼	施礼
十分满意	十分满意
示好	示好
示同意	示同意
示喜	示喜
释放善意	释放善意
手舞足蹈	手舞足蹈
首肯	首肯
守候	守候
守岁	守岁
属望	属望
属意	属意
树碑立传	树碑立传
爽心	爽心
爽怡	爽怡
说好	说好
说好话	说好话
说妥	说妥
说项	说项
思	思
思恋	思恋
思慕	思慕
思念	思念
松心	松心
颂	颂
颂扬	颂扬
颂赞	颂赞
送往迎来	送往迎来
遂心	遂心
遂意	遂意
抬爱	抬爱
抬举	抬举
贪恋	贪恋
贪图	贪图
叹	叹
叹服	叹服
叹赏	叹赏
叹为观止	叹为观止
叹羡	叹羡
陶然	陶然
陶陶	陶陶
陶醉	陶醉
特许	特许
疼	疼
疼爱	疼爱
疼惜	疼惜
提倡	提倡
挑三拣四	挑三拣四
挑眼	挑眼
通过	通过
通融	通融
同意	同意
吐口	吐口
吐气扬眉	吐气扬眉
推	推
推崇	推崇
推戴	推戴
推许	推许
推重	推重
推尊	推尊
望	望
望眼欲穿	望眼欲穿
忘乎所以	忘乎所以
妄想	妄想
问心无愧	问心无愧
无愧	无愧
嘻嘻哈哈	嘻嘻哈哈
稀罕	稀罕
希	希
希罕	希罕
希冀	希冀
希图	希图
喜	喜
喜不自禁	喜不自禁
喜不自胜	喜不自胜
喜冲冲	喜冲冲
喜出望外	喜出望外
喜眉笑眼	喜眉笑眼
喜气洋洋	喜气洋洋
喜上眉梢	喜上眉梢
喜上心头	喜上心头
喜兴	喜兴
喜形于色	喜形于色
喜幸	喜幸
喜洋洋	喜洋洋
喜吟吟	喜吟吟
喜盈盈	喜盈盈
喜悦	喜悦
喜滋滋	喜滋滋
喜孜孜	喜孜孜
显扬	显扬
羡	羡
相中	相中
想	想
想望	想望
向	向
向着	向着
销魂	销魂
消魂	消魂
孝敬	孝敬
孝顺	孝顺
谢	谢
谢天谢地	谢天谢地
欣	欣
欣喜	欣喜
欣喜若狂	欣喜若狂
欣羡	欣羡
欣幸	欣幸
忻	忻
心驰神往	心驰神往
心荡神驰	心荡神驰
心甘	心甘
心甘情愿	心甘情愿
心花怒放	心花怒放
心旷神怡	心旷神怡
心满意足	心满意足
心向	心向
心醉	心醉
兴高采烈	兴高采烈
行礼	行礼
需	需
需要	需要
许	许
许可	许可
轩然	轩然
悬红	悬红
悬赏	悬赏
眼馋	眼馋
眼红	眼红
眼热	眼热
艳羡	艳羡
扬眉吐气	扬眉吐气
扬扬	扬扬
扬扬得意	扬扬得意
扬扬自得	扬扬自得
洋洋得意	洋洋得意
洋洋自得	洋洋自得
仰	仰
仰慕	仰慕
摇头摆尾	摇头摆尾
摇头晃脑	摇头晃脑
夜有所梦	夜有所梦
一往情深	一往情深
揖	揖
依依不舍	依依不舍
依允	依允
以期	以期
以求	以求
意欲	意欲
溢美	溢美
引颈企待	引颈企待
引领	引领
应	应
应承	应承
应下	应下
应许	应许
应允	应允
应准	应准
迎	迎
迎候	迎候
迎接	迎接
迎迓	迎迓
拥	拥
拥戴	拥戴
拥护	拥护
咏赞	咏赞
用	用
用心良苦	用心良苦
有意	有意
俞允	俞允
愉	愉
欲	欲
誉	誉
愿	愿
跃跃欲试	跃跃欲试
悦	悦
悦服	悦服
允	允
允许	允许
允准	允准
在心	在心
在意	在意
赞	赞
赞服	赞服
赞慕	赞慕
赞佩	赞佩
赞赏	赞赏
赞颂	赞颂
赞叹	赞叹
赞同	赞同
赞羡	赞羡
赞许	赞许
赞扬	赞扬
赞誉	赞誉
沾沾自喜	沾沾自喜
照准	照准
折服	折服
珍爱	珍爱
珍视	珍视
珍重	珍重
正中下怀	正中下怀
知冷知热	知冷知热
知冷着热	知冷着热
知足	知足
指靠	指靠
挚爱	挚爱
致贺	致贺
致敬	致敬
致谢	致谢
钟	钟
钟爱	钟爱
钟情	钟情
重在	重在
瞩目	瞩目
瞩望	瞩望
注	注
注意	注意
祝	祝
祝贺	祝贺
祝颂	祝颂
抓	抓
准许	准许
准予	准予
着迷	着迷
着想	着想
着眼	着眼
着眼于	着眼于
自得	自得
自得其乐	自得其乐
自告奋勇	自告奋勇
自满	自满
自鸣得意	自鸣得意
自认	自认
自足	自足
宗仰	宗仰
醉心	醉心
尊崇	尊崇
傧	傧
佥同	佥同
跂望	跂望
讴歌	讴歌
谒	谒
埽	埽
萦念	萦念
揄扬	揄扬
叩	叩
叩拜	叩拜
叩首	叩首
叩头	叩头
啧啧称羡	啧啧称羡
啧啧称赞	啧啧称赞
喁	喁
嗟	嗟
醊	醊
徼	徼
夤	夤
饫	饫
廑	廑
忭	忭
忭跃	忭跃
怏然自足	怏然自足
怿	怿
怡然自得	怡然自得
惬	惬
憧憬	憧憬
迓	迓
嬖	嬖
绻	绻
觊	觊
觊觎	觊觎
犒	犒
犒劳	犒劳
犒赏	犒赏
胪	胪
歆	歆
歆慕	歆慕
歆羡	歆羡
祀	祀
祗	祗
眄	眄
顒	顒
锺	锺
鹄望	鹄望
翊戴	翊戴
裣衽	裣衽
酹	酹
雩	雩
察觉	察觉
触目	触目
耳闻	耳闻
发	发
发觉	发觉
风闻	风闻
见到	见到
见得	见得
觉	觉
看得出来	看得出来
窥见	窥见
领教	领教
听说	听说
痛感	痛感
预感	预感
抱定	抱定
道	道
感到	感到
看	看
看待	看待
论	论
认定	认定
认为	认为
认准	认准
以为	以为
主张	主张
人流	人流
月销售	月销售
跨界	跨界
麦乐购	麦乐购
业模	业模
手推	手推
太极	太极
英国奶粉	英国奶粉
代购价	代购价
马云	马云
转让价格	转让价格
新兴	新兴
皮蛋	皮蛋
加州宝宝	加州宝宝
户型	户型
商业地产	商业地产
爱医院	爱医院
下跌	下跌
平米	平米
找人	找人
做人	做人
超市价格	超市价格
机制	机制
莆田	莆田
两房	两房
苏格兰	苏格兰
国内奶粉	国内奶粉
南特	南特
综合体	综合体
回报	回报
取钱	取钱
英国爱他美	英国爱他美
打劫	打劫
文具	文具
松江	松江
租金	租金
打磨	打磨
投递	投递
合体	合体
拼车	拼车
饲养	饲养
写字楼	写字楼
销售额	销售额
漏气	漏气
移动互联	移动互联
惠康	惠康
便利店	便利店
准备好了	准备好了
新旧	新旧
疗法	疗法
中关村	中关村
肉丸	肉丸
社交	社交
董事	董事
并发	并发
短期	短期
沿线	沿线
世界第一	世界第一
西区	西区
改革	改革
大佬	大佬
服务业	服务业
团购价	团购价
退出	退出
开设	开设
已经成为	已经成为
惠州	惠州
开盘	开盘
宝洁	宝洁
皇家	皇家
互联	互联
族企业	族企业
玫瑰花	玫瑰花
生活方式	生活方式
男友	男友
看不见	看不见
减压	减压
民族企业	民族企业
为公司	为公司
疼痛	疼痛
温馨提示	温馨提示
报纸	报纸
股份	股份
临街	临街
南昌	南昌
本性	本性
隐私	隐私
河北区	河北区
橱柜	橱柜
市价	市价
资金	资金
滑翔	滑翔
海关	海关
增值服务	增值服务
一期	一期
收益	收益
人民医院	人民医院
举动	举动
进行治疗	进行治疗
边界	边界
薇薇	薇薇
食量	食量
营销模式	营销模式
布局	布局
两件套	两件套
大会	大会
三号	三号
可瑞康	可瑞康
线上	线上
到医院	到医院
新华书店	新华书店
凉拌	凉拌
河西	河西
推动	推动
进退	进退
自己的身体	自己的身体
痛苦	痛苦
精装修	精装修
逝去	逝去
全面的	全面的
康复	康复
两厅	两厅
潜力	潜力
取代	取代
写字	写字
格兰	格兰
lobal	lobal
附属	附属
苏宁电器	苏宁电器
弥补	弥补
电气	电气
大影响	大影响
新高	新高
爱他	爱他
不着急	不着急
溪路	溪路
上级	上级
提供了	提供了
GA	GA
东区	东区
行情	行情
摄入	摄入
里边	里边
身子	身子
哪里有卖	哪里有卖
拍下	拍下
地产开发	地产开发
乌鲁木齐	乌鲁木齐
跨国	跨国
应变	应变
要多少钱	要多少钱
水泥	水泥
控制在	控制在
Gate	Gate
把握	把握
短短	短短
奇迹	奇迹
低至	低至
发展	发展
直销	直销
瓶颈	瓶颈
宁海	宁海
观念	观念
大数	大数
精装	精装
国际品牌	国际品牌
好多年	好多年
迅猛	迅猛
现任	现任
中学	中学
面试	面试
董事长	董事长
摩托罗拉	摩托罗拉
巨人	巨人
一个国家	一个国家
培训机构	培训机构
打人	打人
建成	建成
小房	小房
商铺	商铺
层面	层面
翻天	翻天
市北区	市北区
人大	人大
板栗	板栗
铁路	铁路
国际品	国际品
置业	置业
看不清	看不清
资产	资产
学到	学到
商圈	商圈
★★	★★
书本	书本
滑梯	滑梯
方可	方可
有更多的	有更多的
理工	理工
低于	低于
购物小票	购物小票
大规	大规
奶源	奶源
背带	背带
不再是	不再是
病情	病情
恐龙	恐龙
合脚	合脚
腿部	腿部
不影响	不影响
企业的	企业的
爱他美奶粉	爱他美奶粉
公共	公共
二路	二路
楼层	楼层
大规模	大规模
阳区	阳区
平均	平均
mama	mama
后代	后代
开发的	开发的
大促销	大促销
目前的	目前的
协调	协调
腌制	腌制
外贸	外贸
河西区	河西区
等候	等候
转让价	转让价
上升	上升
烟酒	烟酒
万人	万人
一步到位	一步到位
有一定	有一定
委员	委员
比利时	比利时
自提地	自提地
议价	议价
折起	折起
帝国	帝国
太慢	太慢
转身	转身
早期	早期
板块	板块
师大	师大
一方面	一方面
民族	民族
标识	标识
现在正	现在正
总监	总监
五大	五大
立体	立体
考虑到	考虑到
是用来	是用来
几十年	几十年
肝功能	肝功能
新区	新区
个行	个行
供应链	供应链
一方	一方
疲惫	疲惫
行业中	行业中
联系客服	联系客服
不支	不支
模式	模式
好歹	好歹
相关部门	相关部门
治愈	治愈
姿势	姿势
万一	万一
电子商务	电子商务
 	 
和我们	和我们
医疗	医疗
福田	福田
懂得	懂得
还不知道	还不知道
年夜	年夜
真理	真理
配套设施	配套设施
预约	预约
邮寄	邮寄
交叉	交叉
清仓	清仓
相结合	相结合
看到很多	看到很多
那张	那张
但从	但从
是不可	是不可
商厦	商厦
运营商	运营商
大品牌	大品牌
商业街	商业街
销了	销了
积累	积累
直邮	直邮
棉柔	棉柔
年内	年内
店子	店子
第八	第八
现在还在	现在还在
两部	两部
个月内	个月内
倡导	倡导
少数	少数
委员会	委员会
约定	约定
走向	走向
每月	每月
是否有	是否有
首家	首家
直接上	直接上
证券	证券
足以	足以
大姐	大姐
患上	患上
与我联系	与我联系
绵阳	绵阳
完全是	完全是
总裁	总裁
规模	规模
我认为	我认为
排队等	排队等
小手	小手
单元	单元
城中	城中
代码	代码
不散	不散
有价	有价
组成	组成
大型连锁	大型连锁
更全	更全
患者	患者
王府井	王府井
交汇	交汇
越高	越高
牛栏	牛栏
打破	打破
国道	国道
盛世	盛世
越大	越大
中国区	中国区
乘车	乘车
功夫	功夫
筋面	筋面
大学教授	大学教授
不要	不要
越来越少	越来越少
波动	波动
紧邻	紧邻
一对一	一对一
更全面	更全面
质保	质保
出血	出血
指数	指数
北路	北路
东门	东门
极大	极大
介入	介入
儿童乐园	儿童乐园
再度	再度
松紧	松紧
观景	观景
公认	公认
胡同	胡同
武昌	武昌
国国	国国
右手	右手
达到了	达到了
男子	男子
胖胖	胖胖
建材	建材
有更多	有更多
成为了	成为了
安全问题	安全问题
这么多年	这么多年
二环	二环
上半年	上半年
中小	中小
专营店	专营店
电话联系	电话联系
列车	列车
英特网	英特网
在线咨询	在线咨询
限于	限于
市场份额	市场份额
相反	相反
对面	对面
关联	关联
将会	将会
货源	货源
农行	农行
淘宝店铺	淘宝店铺
意味	意味
友谊	友谊
连体	连体
要素	要素
付出	付出
数据	数据
持有	持有
餐吃	餐吃
换来	换来
台前	台前
格局	格局
全网	全网
终点	终点
这个行	这个行
他们有	他们有
只知	只知
体系	体系
批次	批次
灯泡	灯泡
有卖的	有卖的
监控	监控
购物广场	购物广场
沙河	沙河
光大	光大
充满了	充满了
新时	新时
明治	明治
展会	展会
郊区	郊区
城西	城西
问题是	问题是
意味着	意味着
立方	立方
可不可以	可不可以
自取	自取
普及	普及
中国邮政	中国邮政
夏日	夏日
专营	专营
采取	采取
消炎	消炎
策划	策划
英特尔	英特尔
老头	老头
求教	求教
怎么都	怎么都
一应俱全	一应俱全
西市	西市
这个行业	这个行业
要继续	要继续
附近有	附近有
车程	车程
县城	县城
周边	周边
多年来	多年来
返回	返回
最初	最初
理财	理财
斜对面	斜对面
能否	能否
遭遇	遭遇
大批	大批
临床	临床
医药	医药
可以吃	可以吃
团长	团长
主营	主营
瓶装	瓶装
已转	已转
为人	为人
定性	定性
实践	实践
准备好	准备好
能发	能发
菜鸟	菜鸟
财富	财富
购于	购于
简称	简称
世贸	世贸
术前	术前
动漫	动漫
开放	开放
出台	出台
通风	通风
一旦	一旦
眼光	眼光
佳品	佳品
之间	之间
奶粉品	奶粉品
线路	线路
何处	何处
一排	一排
视野	视野
成就了	成就了
一提	一提
爱国	爱国
来自于	来自于
患有	患有
眼里	眼里
大华	大华
数据显示	数据显示
必须有	必须有
特点是	特点是
历时	历时
独有	独有
尽享	尽享
但是在	但是在
橄榄油	橄榄油
中心的	中心的
几乎没有	几乎没有
交叉口	交叉口
不仅仅是	不仅仅是
死皮	死皮
权威	权威
否认	否认
斜对	斜对
各位妈妈	各位妈妈
分销	分销
地段	地段
汇总	汇总
不全	不全
搞了	搞了
截至	截至
花花	花花
账号	账号
青蛙	青蛙
富豪	富豪
随着	随着
商报	商报
经营	经营
更高	更高
只是一个	只是一个
书店	书店
送货上门	送货上门
主管	主管
运作	运作
总额	总额
缺乏	缺乏
遥控	遥控
分为	分为
卖点	卖点
中转	中转
买入	买入
青睐	青睐
工具	工具
炎症	炎症
北大	北大
石油	石油
有卖	有卖
女童	女童
OT	OT
	
系到	系到
上调	上调
变化	变化
索尼	索尼
增加了	增加了
可口可乐	可口可乐
有关系	有关系
就近	就近
续保	续保
最早	最早
超过了	超过了
使我	使我
小鱼	小鱼
成品	成品
车位	车位
我国	我国
均码	均码
走出来	走出来
终身	终身
小猫	小猫
校区	校区
具备	具备
灯光	灯光
运输	运输
ish	ish
到就	到就
太差了	太差了
十几年	十几年
应对	应对
时期	时期
商量	商量
贴纸	贴纸
相互	相互
男款	男款
模仿	模仿
检验	检验
工作室	工作室
燃气	燃气
停车位	停车位
每个月	每个月
苏梅	苏梅
摇篮	摇篮
病毒	病毒
抓绒内胆	抓绒内胆
日常生活	日常生活
早已	早已
护理	护理
随机	随机
古城	古城
房屋	房屋
大年	大年
结帐	结帐
个性化	个性化
照相	照相
旺旺	旺旺
基础上	基础上
烘焙	烘焙
定义	定义
漫长	漫长
一批	一批
开店	开店
扩大	扩大
大事	大事
仅仅	仅仅
南阳	南阳
向西	向西
不确定	不确定
前期	前期
网址	网址
十字	十字
较大	较大
商银	商银
原因是	原因是
特定	特定
工时	工时
柯达	柯达
婚纱摄影	婚纱摄影
主席	主席
英伦	英伦
服务中心	服务中心
关系	关系
手段	手段
没穿	没穿
供应商	供应商
带孩子	带孩子
连锁超市	连锁超市
监督	监督
经历了	经历了
中海	中海
实拍	实拍
已经过	已经过
联想到	联想到
常在	常在
每位	每位
小于	小于
运动休闲	运动休闲
上下班	上下班
了解到	了解到
就会	就会
会展	会展
指导	指导
瑞士	瑞士
居室	居室
发达	发达
看不出	看不出
大润发超市	大润发超市
状况	状况
业内	业内
利益	利益
比较大	比较大
直到	直到
附加	附加
肉肉	肉肉
众多	众多
形象	形象
将于	将于
服务中	服务中
都对	都对
维多利	维多利
食材	食材
六月	六月
做生意	做生意
实行	实行
时间是	时间是
门前	门前
工商银行	工商银行
看病	看病
劳动	劳动
管理	管理
凭证	凭证
在全国	在全国
实现了	实现了
衬衫	衬衫
嘲笑	嘲笑
日用品	日用品
隐患	隐患
占地	占地
转让	转让
搬家	搬家
密度	密度
全国	全国
如果这	如果这
送礼	送礼
棉质	棉质
风雨	风雨
妹纸	妹纸
有货	有货
警惕	警惕
驾车	驾车
直线	直线
地发	地发
操作系统	操作系统
理论	理论
保健品	保健品
科技	科技
顺路	顺路
对话	对话
装上	装上
球场	球场
观察	观察
智慧	智慧
角色	角色
贸易	贸易
特产	特产
留学	留学
小白	小白
两会	两会
三楼	三楼
三层	三层
外包	外包
数学	数学
再生	再生
跟踪	跟踪
吉之岛	吉之岛
店长	店长
打扫	打扫
你自己	你自己
餐费	餐费
组团	组团
中介	中介
小路	小路
后门	后门
观望	观望
Mac	Mac
滨江	滨江
精英	精英
性质	性质
不建议	不建议
承担	承担
获得	获得
实习	实习
考察	考察
组合	组合
下车	下车
后者	后者
接送	接送
好又多	好又多
贝贝	贝贝
家属	家属
失望了	失望了
7-11	7-11
好德	好德
喜士多	喜士多
城市超市	城市超市
全家便利	全家便利
华联	华联
汇金百货	汇金百货
可的便利	可的便利
罗森	罗森
良友	良友
联华	联华
农工商	农工商
百佳	百佳
快客	快客
即时性商品	即时性商品
自选式	自选式
大型零售商	大型零售商
自选商场	自选商场
连锁经营	连锁经营
食物品种	食物品种
连锁店	连锁店
便民服务	便民服务
24小时营业	24小时营业
退瓶	退瓶
DHA	DHA
叶酸	叶酸
核苷酸	核苷酸
牛磺酸	牛磺酸
施恩	施恩
美素佳儿	美素佳儿
贝因美	贝因美
飞鹤	飞鹤
纽莱可	纽莱可
智立方	智立方
亨氏	亨氏
澳优	澳优
雅士利	雅士利
伊利	伊利
特福芬	特福芬
瑚玛娜	瑚玛娜
康维多	康维多
百立乐	百立乐
纽瑞滋	纽瑞滋
贝拉米	贝拉米
纽贝贝	纽贝贝
迈高	迈高
旭贝尔	旭贝尔
美可高特	美可高特
伊卡蓓尔	伊卡蓓尔
御宝	御宝
葡萄糖	葡萄糖
矿物质	矿物质
铁质	铁质
食品检测	食品检测
母乳化奶粉	母乳化奶粉
海外代购	海外代购
亚麻酸	亚麻酸
亚油酸	亚油酸
混合喂养	混合喂养
转奶	转奶
产检	产检
妊娠	妊娠
流产	流产
产期	产期
胎动	胎动
B超检查	B超检查
分娩	分娩
产科	产科
早产	早产
剖腹产	剖腹产
产后	产后
准妈妈	准妈妈
怀孕禁忌	怀孕禁忌
备孕期	备孕期
羊水检查	羊水检查
待产包	待产包
孕期疾病	孕期疾病
健康卵子	健康卵子
先天性疾病	先天性疾病
水肿	水肿
怀孕征兆	怀孕征兆
膳食调节	膳食调节
催产	催产
妊娠期糖尿病	妊娠期糖尿病
孕期补钙	孕期补钙
胎梦	胎梦
生育保险	生育保险
分娩费用	分娩费用
催眠分娩法	催眠分娩法
胎心率	胎心率
托腹带	托腹带
保胎假	保胎假
羊水	羊水
孕妇学校	孕妇学校
呕吐	呕吐
子宫收缩	子宫收缩
坐月子	坐月子
眩晕	眩晕
人工流产	人工流产
止吐药	止吐药
十月妈咪	十月妈咪
百伶妈妈	百伶妈妈
奇妮	奇妮
喜孕娇	喜孕娇
美孕佳人	美孕佳人
欧丽妈咪	欧丽妈咪
时尚俊宝宝	时尚俊宝宝
女之御	女之御
孕之彩	孕之彩
NICEMAMA	NICEMAMA
妈咪秘密	妈咪秘密
凯德氏	凯德氏
莱薇妈咪	莱薇妈咪
喜满	喜满
富逸	富逸
惠葆	惠葆
玛维妮	玛维妮
可可心依	可可心依
蕾曦	蕾曦
怀泰	怀泰
诺宜	诺宜
班罗尔	班罗尔
BERRYYOYO	BERRYYOYO
雅孕	雅孕
唐绵	唐绵
乐禧来	乐禧来
哺乳期	哺乳期
婴儿护理	婴儿护理
智力开发	智力开发
红孩子	红孩子
长牙	长牙
育婴师	育婴师
分泌乳汁	分泌乳汁
保姆月嫂	保姆月嫂
新生儿黄疸	新生儿黄疸
辅助食物	辅助食物
吐奶	吐奶
夜惊	夜惊
体格发育	体格发育
 育婴虐婴	 育婴虐婴
甘草锌	甘草锌
育婴用品	育婴用品
妈咪包	妈咪包
PegPerego	PegPerego
Quinny	Quinny
智高	智高
科德士	科德士
格朗	格朗
呦呦	呦呦
贝莱康	贝莱康
乐儿宝	乐儿宝
日康	日康
本草婴缘	本草婴缘
小白熊	小白熊
易简	易简
袋鼠仔仔	袋鼠仔仔
爱得利	爱得利
有机优蓓	有机优蓓
宜贝儿	宜贝儿
欧润芙	欧润芙
金盾	金盾
施巴	施巴
金盾婴宝	金盾婴宝
亲亲我	亲亲我
蓓氏	蓓氏
宝贝可可丽	宝贝可可丽
铃兰	铃兰
三洋	三洋
康馨儿	康馨儿
掷出窗外	掷出窗外
绿色食品	绿色食品
食品卫生	食品卫生
食品质量	食品质量
食品监管	食品监管
食品检验	食品检验
食品标准	食品标准
食物中毒	食物中毒
有毒食品	有毒食品
致癌	致癌
三聚氰胺	三聚氰胺
卫生部	卫生部
品质标准	品质标准
含铅过多	含铅过多
安全水平	安全水平
卫生不达标	卫生不达标
 检疫不合格	 检疫不合格
无证经营 	无证经营 
产品不合格	产品不合格
违禁品	违禁品
质量监督	质量监督
过氧化值	过氧化值
抗氧化剂 	抗氧化剂 
加工销售	加工销售
饮料中毒	饮料中毒
许可证	许可证
金属含量	金属含量
标准制定	标准制定
风险评估	风险评估
农药残留	农药残留
食品安全监管	食品安全监管
食品安全周刊	食品安全周刊
无检疫证明	无检疫证明
过期食品	过期食品
黑心食品	黑心食品
有害物	有害物
风险监测	风险监测
内酰胺酶	内酰胺酶
溴酸钾	溴酸钾
化合物	化合物
国际标准	国际标准
中国标准	中国标准
重金属	重金属
对人体有害	对人体有害
家家乐购	家家乐购
乐客乐购	乐客乐购
花都乐购	花都乐购
飞虎乐购	飞虎乐购
特价乐购	特价乐购
乐游乐购	乐游乐购
杏仁菜菜乐购	杏仁菜菜乐购
欢乐购物	欢乐购物
哈哈	哈哈
代购价格	代购价格
代购产品	代购产品
新旧程度	新旧程度
超市采购	超市采购
罐的	罐的
贴牌	贴牌
撒尿牛丸	撒尿牛丸
英国的	英国的
喂养的	喂养的
所有产品	所有产品
爆罐	爆罐
代购货	代购货
致死	致死
元 	元 
时效性	时效性
更多	更多
以下简称	以下简称
的时效性	的时效性
代购货源	代购货源
比较严	比较严
港代	港代
插线板	插线板
日内	日内
打折信息	打折信息
生活日用	生活日用
元/包	元/包
粉进	粉进
大连锁	大连锁
降低了	降低了
裕的	裕的
国邮	国邮
好像有	好像有
王道	王道
参考价	参考价
很安全	很安全
中转的	中转的
自行负责	自行负责
任何费用	任何费用
包揽	包揽
详情见	详情见
换算	换算
拍下的	拍下的
用本	用本
爱他美	爱他美
有产品	有产品
EMS	EMS
谁知	谁知
整个	整个
市中	市中
团购	团购
产品代购	产品代购
英国直邮	英国直邮
品代购	品代购
还在	还在
学区	学区
到现在	到现在
变成	变成
不合	不合
做到	做到
马上	马上
%以上	%以上
自提地点	自提地点
具有	具有
段奶粉	段奶粉
还有一个	还有一个
一种	一种
有一个	有一个
哪有卖	哪有卖
很多妈妈	很多妈妈
外包装	外包装
明显的	明显的
旁边	旁边
活动的	活动的
术的	术的
是什么	是什么
高筋面粉	高筋面粉
一定要	一定要
哪一	哪一
大量的	大量的
有效的	有效的
后果	后果
进入	进入
在超市	在超市
所以说	所以说
越少	越少
已经有	已经有
其次	其次
奥运	奥运
各界	各界
情感	情感
东芝	东芝
鼓励	鼓励
面粉	面粉
地处	地处
采购	采购
缺陷	缺陷
相关	相关
往下	往下
有要求	有要求
站内	站内
在英国	在英国
前一天	前一天
反弹	反弹
搬到	搬到
矛盾	矛盾
跟风	跟风
全方位	全方位
叫什么	叫什么
绝不是	绝不是
意向	意向
是非	是非
提货	提货
观点	观点
水 	水 
共同	共同
要求	要求
第三方	第三方
原创	原创
化学	化学
邮局	邮局
直通	直通
单鞋	单鞋
应有尽有	应有尽有
改变了	改变了
环绕	环绕
已有	已有
行人	行人
笑了	笑了
并未	并未
来来	来来
奶牛	奶牛
多数	多数
专车	专车
华联超市	华联超市
三分	三分
除非	除非
此次	此次
电视台	电视台
条形码	条形码
路面	路面
套房	套房
发出	发出
而且也	而且也
上述	上述
超过	超过
宽度	宽度
实力	实力
冷冻	冷冻
好孩子	好孩子
正在	正在
指出	指出
蜜蜂	蜜蜂
三段	三段
很长	很长
中信	中信
游泳池	游泳池
方面	方面
群体	群体
长江	长江
超市里	超市里
果味	果味
正规	正规
部件	部件
困扰	困扰
禁止	禁止
西藏	西藏
人间	人间
血液	血液
则是	则是
西方	西方
放入	放入
制度	制度
近年	近年
致力于	致力于
青岛	青岛
支撑	支撑
疯了	疯了
超高	超高
台塑牛排	台塑牛排
降至	降至
专家介绍	专家介绍
生产	生产
想找	想找
两者	两者
三分之一	三分之一
原装进口	原装进口
超多	超多
大型超市	大型超市
短袖	短袖
两双	两双
预算	预算
装进	装进
跟着	跟着
转换	转换
中国移动	中国移动
这时	这时
提到	提到
疑问	疑问
交通工具	交通工具
其中	其中
停止	停止
副总	副总
余额	余额
思维	思维
大人	大人
总价	总价
心地	心地
下架	下架
客厅	客厅
南亚	南亚
最先	最先
有许多	有许多
留给	留给
便宜点	便宜点
进来	进来
在大润发	在大润发
家乐福超市	家乐福超市
特别好	特别好
无限	无限
技术	技术
引发了	引发了
自提	自提
时间长	时间长
有线	有线
坐上	坐上
法院	法院
先是	先是
复制	复制
几分钟	几分钟
人力	人力
真假	真假
第一家	第一家
蛮喜欢	蛮喜欢
朝阳	朝阳
自有	自有
不同	不同
史上	史上
最低价	最低价
至于	至于
一番	一番
储蓄	储蓄
密封	密封
一座	一座
深层	深层
想要	想要
咨询	咨询
泳衣	泳衣
门市	门市
常见	常见
第二个	第二个
联系	联系
格子	格子
广泛	广泛
打折	打折
截图	截图
有助于	有助于
货号	货号
汇报	汇报
日语	日语
本身	本身
item	item
上回	上回
一楼	一楼
条款	条款
依据	依据
陷阱	陷阱
七月	七月
活动时	活动时
仅是	仅是
站立	站立
新增	新增
此事	此事
做过	做过
海边	海边
后期	后期
带过	带过
条形	条形
只为	只为
本土	本土
数量	数量
很近	很近
接着	接着
三次	三次
到目前	到目前
杭州市	杭州市
食品添加剂	食品添加剂
雪纺	雪纺
罚款	罚款
有可能	有可能
节前	节前
比较便宜	比较便宜
每天早上	每天早上
花朵	花朵
feel	feel
测量	测量
一分钟	一分钟
美团	美团
贴上	贴上
人参	人参
木地	木地
彼此	彼此
薄荷	薄荷
未必	未必
目前	目前
才能	才能
大码	大码
转出	转出
范围内	范围内
可拆	可拆
育儿	育儿
放心	放心
轻轨	轻轨
判断	判断
收货	收货
都市	都市
乐高	乐高
广大	广大
石化	石化
邮件	邮件
太原	太原
优惠多	优惠多
做出	做出
市北	市北
总算	总算
在家乐福	在家乐福
伦敦	伦敦
第三	第三
这个世界	这个世界
通讯	通讯
幅度	幅度
跟帖	跟帖
瘦身	瘦身
太原街	太原街
低音	低音
海外	海外
mail	mail
过去	过去
一岁	一岁
寻找	寻找
没时间	没时间
资格	资格
取货	取货
本次	本次
近年来	近年来
加重	加重
根据	根据
聚划算	聚划算
蕾丝	蕾丝
比较划算	比较划算
活动时间	活动时间
缩短	缩短
解放	解放
下载次数	下载次数
做活动	做活动
幼儿配方	幼儿配方
留在	留在
淘宝网	淘宝网
通常	通常
经过	经过
对接	对接
还价	还价
平底	平底
万达广场	万达广场
雅培	雅培
凉鞋	凉鞋
家电	家电
中行	中行
我需要	我需要
对方	对方
翻新	翻新
而是	而是
驱动	驱动
外来	外来
怎么说	怎么说
次数	次数
以内	以内
知名度	知名度
老板娘	老板娘
生物	生物
没话说	没话说
它们	它们
个人	个人
信誉	信誉
盖子	盖子
ID	ID
万能	万能
特有	特有
售出	售出
差评	差评
最终	最终
T恤	T恤
冰淇淋	冰淇淋
饿了	饿了
针织	针织
天地	天地
慢慢	慢慢
转向	转向
得到	得到
真心好	真心好
制定	制定
注明	注明
货架上	货架上
暖气	暖气
同比增长	同比增长
必须	必须
更重要	更重要
三种	三种
戴尔	戴尔
发病	发病
爸爸妈妈	爸爸妈妈
卫生巾	卫生巾
大门	大门
看出	看出
系列产品	系列产品
书房	书房
路口	路口
到来	到来
木地板	木地板
娃哈哈	娃哈哈
派出所	派出所
Qzone	Qzone
第一时间	第一时间
家装	家装
使得	使得
场内	场内
损伤	损伤
控制	控制
定比	定比
虹桥	虹桥
容的	容的
原来的	原来的
稀土	稀土
泡芙	泡芙
脚步	脚步
沃尔玛超市	沃尔玛超市
建行	建行
内部	内部
江西	江西
注意事项	注意事项
很热	很热
现状	现状
保质	保质
都不错	都不错
指定	指定
卫生间	卫生间
帮助	帮助
家园	家园
得知	得知
花板	花板
拉面	拉面
麦德龙	麦德龙
人数	人数
水货	水货
第六	第六
进行了	进行了
发表于	发表于
过程中	过程中
慢性	慢性
很值	很值
帐号	帐号
沿海	沿海
整体	整体
标注	标注
大厅	大厅
新技术	新技术
爱尔兰	爱尔兰
表明	表明
身体健康	身体健康
证明	证明
微波	微波
大爷	大爷
七分	七分
实地	实地
仪式	仪式
路程	路程
一对	一对
对的	对的
协商	协商
跟团	跟团
制药	制药
附上	附上
咳嗽	咳嗽
婴儿床	婴儿床
种情	种情
网易	网易
派出	派出
加价	加价
并非	并非
山姆	山姆
了解	了解
可见	可见
追求	追求
领导	领导
并不	并不
无论	无论
公用	公用
保证	保证
上车	上车
过后	过后
钱包	钱包
国度	国度
人士	人士
缓慢	缓慢
加油站	加油站
无线	无线
米线	米线
天桥	天桥
从来	从来
格式	格式
二期	二期
登记	登记
接口	接口
海淀	海淀
出国	出国
事项	事项
自用	自用
女式	女式
及其	及其
据了解	据了解
焦点	焦点
烤鸭	烤鸭
等级	等级
走到	走到
外部	外部
sina	sina
受到	受到
正是	正是
二点	二点
厘米 	厘米 
正式	正式
龙虾	龙虾
挑选	挑选
从事	从事
在中国	在中国
睡衣	睡衣
民间	民间
透过	透过
西式	西式
休闲娱乐	休闲娱乐
无袖	无袖
最少	最少
最重	最重
特殊	特殊
宝贝们	宝贝们
解决了	解决了
具体	具体
加上	加上
海景	海景
价格差	价格差
等于	等于
尝试	尝试
亏本	亏本
咱们	咱们
象征	象征
心脏	心脏
感染	感染
市场上	市场上
吵架	吵架
定点	定点
不愧是	不愧是
走访	走访
由于	由于
右	右
周一	周一
到手	到手
腰围	腰围
害人	害人
国内	国内
发生	发生
前三	前三
场所	场所
对其	对其
情况	情况
世纪联华	世纪联华
福建	福建
上班	上班
引起	引起
穿过	穿过
水煮	水煮
体现	体现
突破	突破
吸奶	吸奶
龙头	龙头
然而	然而
却不	却不
锅	锅
设立	设立
是必	是必
场上	场上
立马	立马
哪些	哪些
每个	每个
比起	比起
向前	向前
备注	备注
卖给	卖给
联合	联合
短裙	短裙
他人	他人
维持	维持
产奶	产奶
差价	差价
北海	北海
生产日期	生产日期
等等	等等
活动地	活动地
多少	多少
包括	包括
调料	调料
货品	货品
恐怕	恐怕
适用于	适用于
嘿嘿	嘿嘿
对于	对于
达到	达到
收取	收取
甚至	甚至
送来	送来
小妹	小妹
哪怕	哪怕
单价	单价
贴身	贴身
消化	消化
行为	行为
指引	指引
厘米	厘米
陆续	陆续
造成	造成
法律	法律
老太太	老太太
走过去	走过去
工程	工程
肥牛	肥牛
我老公	我老公
三合一	三合一
转给	转给
完毕	完毕
三环	三环
决心	决心
官员	官员
步行街	步行街
提醒	提醒
赠送	赠送
供货	供货
弹力	弹力
很强	很强
小编	小编
主流	主流
网店	网店
前往	前往
现代化	现代化
或是	或是
部分	部分
损害	损害
国际机	国际机
十天	十天
消费者权益	消费者权益
游乐	游乐
摆放	摆放
入驻	入驻
楼上	楼上
吊带	吊带
门店	门店
发生了	发生了
高一	高一
车厢	车厢
本事	本事
同仁	同仁
属于	属于
大悦城	大悦城
专柜正品	专柜正品
超低价	超低价
抽屉	抽屉
最全	最全
内容	内容
山水	山水
毫不	毫不
身份证	身份证
十元	十元
左右	左右
小资	小资
时刻	时刻
港澳	港澳
拖鞋	拖鞋
亏了	亏了
买下	买下
等待	等待
人口	人口
煎饼	煎饼
学时	学时
确实不错	确实不错
中医	中医
蜂窝	蜂窝
环境好	环境好
充值	充值
感觉很好	感觉很好
物超所值	物超所值
菜式	菜式
带着	带着
支出	支出
顾客	顾客
采用	采用
有需要	有需要
消耗	消耗
近期	近期
亲自	亲自
破坏	破坏
发热	发热
当下	当下
人民	人民
凡客	凡客
欺骗	欺骗
小号	小号
东部	东部
富含	富含
逆天	逆天
百事	百事
里程	里程
海棠	海棠
不高兴	不高兴
合约	合约
三角	三角
到货	到货
初步	初步
养成	养成
一同	一同
最大	最大
地区	地区
平民	平民
山区	山区
夏至	夏至
较小	较小
非常好用	非常好用
使用后	使用后
大楼	大楼
经验	经验
开发区	开发区
减轻	减轻
马桶	马桶
市里	市里
奶油	奶油
许多	许多
而已	而已
开封	开封
门外	门外
同时	同时
长袖	长袖
不给	不给
结算	结算
中国市场	中国市场
血管	血管
易初莲花	易初莲花
接下	接下
在美国	在美国
在国外	在国外
大小	大小
一晚上	一晚上
大部分	大部分
得出	得出
全天	全天
基本上	基本上
很难	很难
病患	病患
信息	信息
东海	东海
在网上	在网上
危害	危害
专柜	专柜
服务态度差	服务态度差
病人	病人
指示	指示
不绝	不绝
蓝莓	蓝莓
负担	负担
小巷	小巷
开学	开学
在德国	在德国
每个人	每个人
召开	召开
买东西	买东西
就够	就够
近几年	近几年
散发	散发
原则	原则
作为	作为
拼接	拼接
夏季	夏季
从中	从中
很热情	很热情
以及	以及
纪念品	纪念品
有时间	有时间
初期	初期
宝宝们	宝宝们
选购	选购
如果	如果
桃花	桃花
感受	感受
火车站	火车站
他们	他们
降价	降价
金钱	金钱
字母	字母
后面	后面
所有	所有
长时间	长时间
两种	两种
某个	某个
分钟	分钟
疯子	疯子
对应	对应
报销	报销
面对	面对
买一个	买一个
这几年	这几年
去年	去年
能理解	能理解
窗户	窗户
想出	想出
标题	标题
滑轮	滑轮
pizza	pizza
豹纹	豹纹
存在	存在
寿命	寿命
每人	每人
你要	你要
好东西	好东西
美金	美金
路边	路边
不仅	不仅
二层	二层
权益	权益
山路	山路
如此	如此
导购	导购
火车	火车
非常高	非常高
走起	走起
防风	防风
或者	或者
先生	先生
人事	人事
出自	出自
有时	有时
毕竟	毕竟
中药	中药
西部	西部
八一	八一
这些	这些
很高	很高
看起来	看起来
威胁	威胁
不靠谱	不靠谱
角落	角落
导致	导致
最好用	最好用
这种事	这种事
一人	一人
负责人	负责人
秩序	秩序
客户服务	客户服务
华硕	华硕
你想	你想
保留	保留
皇冠	皇冠
我的脸	我的脸
很小	很小
饭堂	饭堂
我希望	我希望
还不能	还不能
左转	左转
装置	装置
较多	较多
今后	今后
就能	就能
适合自己	适合自己
有关	有关
也可以	也可以
我不知	我不知
引用	引用
不靠	不靠
要的	要的
一路	一路
财经	财经
OG	OG
显示	显示
IG	IG
澳大	澳大
有办法	有办法
星期五	星期五
胡椒	胡椒
小的	小的
到好	到好
我可以	我可以
退休	退休
10	10
不是一个	不是一个
tac	tac
刚刚好	刚刚好
两家	两家
 金	 金
几件	几件
北京市	北京市
别人	别人
买奶粉	买奶粉
好多人	好多人
公务员	公务员
又没有	又没有
早上	早上
大概	大概
跟上	跟上
专门	专门
穿起	穿起
也喜欢	也喜欢
什么都没	什么都没
淡香	淡香
厂商	厂商
很适合	很适合
哪个	哪个
两个人	两个人
推荐大家	推荐大家
回复	回复
一个	一个
And	And
盒装	盒装
男女款	男女款
业界	业界
不够	不够
只要	只要
去超市	去超市
所以	所以
名额	名额
蛋挞	蛋挞
合身	合身
分公司	分公司
瘦脸	瘦脸
物价	物价
香草	香草
拿回	拿回
雅诗兰黛	雅诗兰黛
高达	高达
家人	家人
常有	常有
不需要	不需要
很时尚	很时尚
赢得	赢得
这种情况	这种情况
第二	第二
拿出来	拿出来
一件事	一件事
赶快	赶快
肯定会	肯定会
常去	常去
情侣	情侣
抓绒衣	抓绒衣
舍不得	舍不得
一套	一套
今年	今年
一群	一群
假货	假货
绝对是	绝对是
敢买	敢买
不远	不远
都会	都会
阿萨姆	阿萨姆
在西安	在西安
多功能	多功能
哈根达斯	哈根达斯
茶叶	茶叶
生蚝	生蚝
水壶	水壶
损坏	损坏
也是	也是
其他	其他
只是	只是
总有	总有
原本	原本
原有	原有
说过	说过
才发现	才发现
休息	休息
这种	这种
通知	通知
并且	并且
没问题	没问题
补偿	补偿
很简单	很简单
这东西	这东西
我感觉	我感觉
三里屯	三里屯
差不多	差不多
审核	审核
肉质	肉质
没错	没错
汤圆	汤圆
没有人	没有人
即使	即使
感性	感性
联系我	联系我
很多人	很多人
显得	显得
一盒	一盒
魅族	魅族
将近	将近
在哪	在哪
意见	意见
不一	不一
好像	好像
家庭	家庭
后续	后续
短裤	短裤
在商场	在商场
不信	不信
喇叭	喇叭
都有	都有
经销	经销
那里	那里
打包	打包
楼下	楼下
正版	正版
安全性	安全性
菜单	菜单
亲戚	亲戚
车道	车道
年轻人	年轻人
成果	成果
新款	新款
全场	全场
生产许可	生产许可
便携	便携
基本都	基本都
高血压	高血压
当时我	当时我
加厚	加厚
一早	一早
星级酒店	星级酒店
决不	决不
好几次	好几次
过来	过来
沉淀	沉淀
推荐一下	推荐一下
在香港	在香港
是因为	是因为
对此	对此
回到	回到
就是	就是
岁月	岁月
这辆	这辆
真的好	真的好
是否	是否
叫我	叫我
洲际	洲际
都这样	都这样
丢失	丢失
只在	只在
坚持	坚持
国航	国航
抛弃	抛弃
太阳	太阳
这个是	这个是
他说	他说
用于	用于
只能	只能
花色	花色
不要错过	不要错过
无语	无语
查看	查看
一双	一双
不适	不适
服饰	服饰
告诉	告诉
电压	电压
很干净	很干净
宽敞	宽敞
名字	名字
露营	露营
我心里	我心里
我想问	我想问
护发	护发
即可	即可
如题	如题
网上	网上
但也	但也
環境	環境
一点点	一点点
四个	四个
一件	一件
一半	一半
穿不	穿不
来自	来自
吃吗	吃吗
我不要	我不要
超便宜	超便宜
在这个	在这个
希望你	希望你
请大家	请大家
早晨	早晨
有很多	有很多
去换	去换
不干	不干
就没	就没
我当	我当
我被	我被
日前	日前
最喜欢	最喜欢
出行	出行
回复@	回复@
挺有	挺有
网友	网友
等位	等位
说到	说到
一生	一生
还剩	还剩
是正品	是正品
另有	另有
调节	调节
去吧	去吧
很快就	很快就
还想	还想
十个	十个
开门	开门
我都不	我都不
背心	背心
是怎么回事	是怎么回事
替我	替我
给我说	给我说
就快	就快
一个多月	一个多月
车里	车里
就像	就像
对我	对我
没有了	没有了
只会	只会
三个	三个
呵呵	呵呵
吃过	吃过
牛仔裤	牛仔裤
只需	只需
围巾	围巾
朋友介绍	朋友介绍
太棒	太棒
延迟	延迟
可选	可选
一位	一位
价格不	价格不
肥胖	肥胖
鲜的	鲜的
推荐了	推荐了
都不是	都不是
进门	进门
市东	市东
发现自己	发现自己
不会	不会
能有	能有
没发现	没发现
很暖	很暖
相当不错	相当不错
也有	也有
当场	当场
它的	它的
有时候	有时候
本来就	本来就
自从	自从
另外	另外
我家	我家
真没	真没
他家	他家
江苏	江苏
睡着	睡着
几个	几个
能保证	能保证
自己不	自己不
 去	 去
这里的	这里的
对不起	对不起
只有	只有
听说过	听说过
回老家	回老家
嫂子	嫂子
周年	周年
出去	出去
五分	五分
月份	月份
于是	于是
去过	去过
服务态度也	服务态度也
很好的	很好的
心动	心动
茄子	茄子
自助游	自助游
一时	一时
直径	直径
就是有	就是有
不多了	不多了
两只	两只
怎么了	怎么了
去看	去看
现在就	现在就
自力	自力
开玩笑	开玩笑
换一个	换一个
不怎么样	不怎么样
而且是	而且是
求推荐	求推荐
不给力	不给力
多人	多人
放在	放在
尝尝	尝尝
牛的	牛的
这件	这件
还是不错的	还是不错的
收纳	收纳
那些	那些
香飘飘	香飘飘
乘坐	乘坐
东航	东航
EA	EA
做了	做了
Inc	Inc
退换货	退换货
类型	类型
当时	当时
看吧	看吧
一样的	一样的
梦中	梦中
这是	这是
硬盘	硬盘
我的车	我的车
什么东西	什么东西
用后	用后
迪奥	迪奥
Dior	Dior
彩妆规格	彩妆规格
贵了	贵了
一整	一整
底液	底液
比其	比其
化妆美容	化妆美容
美容工具	美容工具
要比	要比
防晒乳	防晒乳
都不用	都不用
脸上	脸上
化妆品功效	化妆品功效
◆◆	◆◆
发质	发质
价格实惠	价格实惠
真有	真有
藿香	藿香
气味	气味
值了	值了
蝴蝶结	蝴蝶结
正常规格化	正常规格化
也不会	也不会
还贵	还贵
到我	到我
一点也	一点也
化妆品品牌	化妆品品牌
家乐	家乐
能让	能让
ita	ita
网商	网商
心情	心情
也不贵	也不贵
用起来	用起来
其它化妆品	其它化妆品
样品	样品
化妆品特性	化妆品特性
这个	这个
重要是	重要是
其他功效	其他功效
小样中样	小样中样
去大润发	去大润发
那种	那种
要用	要用
就一个	就一个
买回来	买回来
美了	美了
天 	天 
特性	特性
不承认	不承认
要便宜	要便宜
用这个	用这个
个人觉得	个人觉得
在乐购	在乐购
能用	能用
正常规格	正常规格
会选择	会选择
欧莱雅	欧莱雅
香肠	香肠
效果 	效果 
带有	带有
认证	认证
所有肤质	所有肤质
抗敏感	抗敏感
忍受	忍受
一碗	一碗
博文	博文
单品	单品
去逛	去逛
酒红色 	酒红色 
我发现	我发现
高了	高了
一分货	一分货
一元	一元
我们家	我们家
围观	围观
err	err
干性	干性
DO	DO
没买	没买
实在太	实在太
海绵	海绵
浅绿色	浅绿色
抗敏感 	抗敏感 
不含	不含
原来是	原来是
常使用	常使用
形容	形容
类别	类别
在看	在看
多元	多元
还以为	还以为
小姐	小姐
入住	入住
一下子	一下子
乖乖	乖乖
可以做	可以做
晚了	晚了
收到了	收到了
不小	不小
中样	中样
浅绿	浅绿
酒红色	酒红色
很大	很大
为何	为何
这个牌子	这个牌子
去乐购	去乐购
回去	回去
也很好	也很好
一段时间	一段时间
两张	两张
质量不错	质量不错
RT	RT
如果不	如果不
兴奋	兴奋
一样	一样
UR	UR
三家	三家
十块	十块
可以有	可以有
去欧尚	去欧尚
加水	加水
这家店	这家店
给宝宝	给宝宝
tyle	tyle
产品名称	产品名称
试了	试了
不得不	不得不
莫名	莫名
很干	很干
温和度	温和度
大家一起	大家一起
动静	动静
静电	静电
适合肤质	适合肤质
很想	很想
更适合	更适合
死人	死人
一块	一块
year	year
小饼	小饼
太坑爹	太坑爹
来玩	来玩
不是	不是
化妆品规格	化妆品规格
城县	城县
皮材质	皮材质
咀嚼	咀嚼
大家好	大家好
已经是	已经是
人性	人性
酒红	酒红
适合人群	适合人群
粉红色 	粉红色 
使用效果 	使用效果 
要么	要么
@亚航	@亚航
这款	这款
秋季	秋季
还真是	还真是
谁来	谁来
可以买	可以买
化妆品容量	化妆品容量
每次都	每次都
own	own
去香港	去香港
my	my
在里面	在里面
吃起来	吃起来
希望有	希望有
泉水	泉水
We	We
所有人	所有人
杂志	杂志
多久	多久
不说了	不说了
还是有	还是有
很开心	很开心
一首	一首
今天去	今天去
Of	Of
全球最	全球最
现在是	现在是
我想说	我想说
马上就	马上就
可能是	可能是
想知道	想知道
我问	我问
很满意	很满意
g/ml	g/ml
几百	几百
能手	能手
有房	有房
推荐给大家	推荐给大家
刚才	刚才
抱着	抱着
可以用	可以用
聚美	聚美
传说	传说
行了	行了
很多东西	很多东西
拿下	拿下
堪称	堪称
她家	她家
多美	多美
省了	省了
室外	室外
台上	台上
一体	一体
味道超好	味道超好
睡觉	睡觉
口气	口气
那么多人	那么多人
有一些	有一些
真是好	真是好
很正	很正
去医院	去医院
对于我	对于我
昨天 	昨天 
仔面	仔面
女裤	女裤
CPU	CPU
有免费	有免费
常来	常来
几乎	几乎
法国	法国
看上去	看上去
走过	走过
yea	yea
东东	东东
 使用效果	 使用效果
缝制	缝制
适用人群	适用人群
一次	一次
可以说	可以说
用手机	用手机
超喜欢	超喜欢
而不是	而不是
面子	面子
纠结了	纠结了
其它	其它
一瓶	一瓶
忘了	忘了
千万别	千万别
好意	好意
今天是	今天是
说实话	说实话
几年	几年
顺德	顺德
大屏	大屏
记得	记得
一个好	一个好
要好	要好
在此	在此
七天	七天
人看	人看
荷叶	荷叶
超喜	超喜
一个小时	一个小时
拿来	拿来
吃得	吃得
以买	以买
一直以	一直以
也就是	也就是
过得	过得
工人	工人
之后就	之后就
不来	不来
收了	收了
都没人	都没人
不可	不可
同一	同一
现在还没	现在还没
人手	人手
柜子	柜子
大优	大优
司馬蓮	司馬蓮
羅綾秀	羅綾秀
寶二爺	寶二爺
宝二爷	宝二爷
顾源	顾源
顾里	顾里
萧逸寒	萧逸寒
洛锦谦	洛锦谦
邵驿	邵驿
萧莫	萧莫
陈素	陈素
薛墨弦	薛墨弦
林青桦	林青桦
大嫂	大嫂
大陆已出版	大陆已出版
做孕前检查	做孕前检查
染色体检查	染色体检查
肌瘤	肌瘤
妇产医院	妇产医院
曲张	曲张
打胎	打胎
公立医院	公立医院
西塘	西塘
包皮	包皮
薪酬	薪酬
太极拳	太极拳
日照	日照
成长股	成长股
估值	估值
商业模式	商业模式
投资者	投资者
胸围	胸围
臀围	臀围
裆长	裆长
裤长	裤长
无锡市	无锡市
学员	学员
大亚湾	大亚湾
点钞	点钞
人民币  	人民币  
港币 	港币 
整合	整合
体检	体检
腹腔	腹腔
闭合	闭合
生殖	生殖
教师	教师
公交路线	公交路线
诊断	诊断
那天	那天
值班	值班
静脉瓣膜	静脉瓣膜
医师	医师
结扎	结扎
卵巢囊肿	卵巢囊肿
开刀	开刀
第一步	第一步
窗口	窗口
按钮	按钮
囊肿	囊肿
先天	先天
回流	回流
下肢	下肢
微创	微创
激光	激光
无法挽救	无法挽救
扩张	扩张
输卵管	输卵管
复发	复发
卵巢	卵巢
阴道	阴道
粘连	粘连
不孕	不孕
盆腔	盆腔
静脉	静脉
外资	外资
挽救	挽救
巨头	巨头
零售业	零售业
就诊指南	就诊指南
专家咨询	专家咨询
第五医院	第五医院
南昌市	南昌市
在线医生	在线医生
不孕不育	不孕不育
内膜	内膜
手术室	手术室
子宫内	子宫内
宫颈	宫颈
病因	病因
乙肝	乙肝
肝病	肝病
终止	终止
病例	病例
门诊	门诊
建筑面积	建筑面积
手术费用	手术费用
检查项目	检查项目
检查费用	检查费用
术前检查	术前检查
人流价格	人流价格
B超	B超
北站	北站
福田区	福田区
涨幅	涨幅
报道	报道
并发症	并发症
全球范围内	全球范围内
绩效	绩效
对外	对外
并购	并购
诊疗	诊疗
特征	特征
生育	生育
分析	分析
曲张	曲张
静脉曲张	静脉曲张
麻醉	麻醉
学位	学位
中心区	中心区
商业中心	商业中心
手机号码	手机号码
咨询热线	咨询热线
免费咨询	免费咨询
全国免费	全国免费
治疗	治疗
适用范围	适用范围
专家	专家
在线专家	在线专家
临床治疗	临床治疗
效果持久	效果持久
专家热线	专家热线
妇科医院	妇科医院
服务	服务
商贸	商贸
滨湖区	滨湖区
咨询预约	咨询预约
房租	房租
身体情况	身体情况
费用问题	费用问题
意外怀孕	意外怀孕
女性朋友	女性朋友
人流手术	人流手术
手术刀	手术刀
小三	小三
森林公园	森林公园
性别	性别
专科	专科
积水	积水
地址栏	地址栏
超链接	超链接
东边	东边
远期	远期
手机号	手机号
不支持	不支持
引进	引进
妇科	妇科
专家	专家